Белаконева Алега Аляксеевіча|	Белаконеў Алег Аляксеевіч
Васкабойнага Мікалая Аляксеевіча|	Васкабойны Мікалай Аляксеевіч
Жука Андрэя Уладзіміравіча|	Жук Андрэй Уладзіміравіч
Іванова Вячаслава Анатольевіча|	Іваноў Вячаслаў Анатольевіч
Лесуна Алега Мікалаевіча|	Лесун Алег Мікалаевіч
Лінкевіча Валерыя Леанідавіча|	Лінкевіч Валерый Леанідавіч
Лук’яновіча Андрэя Юльянавіча|	Лук’яновіч Андрэй Юльянавіч
Матрашылу Ігара Фадзеевіча|	Матрашыла Ігар Фадзеевіч
Маханькова Сяргея Уладзіміравіча|	Маханькоў Сяргей Уладзіміравіч
Мельнікава Алега Іванавіча|	Мельнікаў Алег Іванавіч
Раўкова Андрэя Аляксеевіча|	Раўкоў Андрэй Аляксеевіч
Чэкана Васілія Іванавіча|	Чэкан Васілій Іванавіч
Якаўлева Алега Уладзіміравіча|	Якаўлеў Алег Уладзіміравіч
Літвінаву Зою Васільеўну|	Літвінава Зоя Васільеўна
Акуліка Валерыя Міхайлавіча|	Акулік Валерый Міхайлавіч
Анціпенкава Аляксея Уладзіміравіча|	Анціпенкаў Аляксей Уладзіміравіч
Бабруйскага Юрыя Аляксандравіча|	Бабруйскі Юрый Аляксандравіч
Баса Аляксандра Іванавіча|	Бас Аляксандр Іванавіч
Беганскага Віталія Аляксандравіча|	Беганскі Віталій Аляксандравіч
Бойку Валерыя Уладзіміравіча|	Бойка Валерый Уладзіміравіч
Вараб’ёва Кірыла Уладзіслававіча|	Вараб’ёў Кірыл Уладзіслававіч
Дзехцяра Валерыя Ігаравіча|	Дзехцяр Валерый Ігаравіч
Жылюка Сяргея Аляксеевіча|	Жылюк Сяргей Аляксеевіч
Зайцава Дзмітрыя Анатольевіча|	Зайцаў Дзмітрый Анатольевіч
Зубарэнку Юрыя Міхайлавіча|	Зубарэнка Юрый Міхайлавіч
Зубенку Дзяніса Аляксандравіча|	Зубенка Дзяніс Аляксандравіч
Ізбаша Міхаіла Юр’евіча|	Ізбаш Міхаіл Юр’евіч
Кіркевіча Юрыя Станіслававіча|	Кіркевіч Юрый Станіслававіч
Клішэвіча Андрэя Уладзіміравіча|	Клішэвіч Андрэй Уладзіміравіч
Лазоўскага Сяргея Лявонцьевіча|	Лазоўскі Сяргей Лявонцьевіч
Лучанка Дзмітрыя Аляксандравіча|	Лучанок Дзмітрый Аляксандравіч
Машкова Яўгенія Мікалаевіча|	Машкоў Яўгеній Мікалаевіч
Міцкевіча Ігара Уладзіміравіча|	Міцкевіч Ігар Уладзіміравіч
Муліцу Валерыя Іванавіча|	Муліца Валерый Іванавіч
Нагавіцына Аляксандра Усеваладавіча|	Нагавіцын Аляксандр Усеваладавіч
Науменку Артура Аляксандравіча|	Науменка Артур Аляксандравіч
Норкуса Андрыуса Рамуалдавіча|	Норкус Андрыус Рамуалдавіч
Панфёрава Аляксандра Іванавіча|	Панфёраў Аляксандр Іванавіч
Парчука Аляксандра Васільевіча|	Парчук Аляксандр Васільевіч
Парывая Сяргея Вітальевіча|	Парывай Сяргей Вітальевіч
Пестава Дзмітрыя Анатольевіча|	Пестаў Дзмітрый Анатольевіч
Пузакова Сяргея Валер’евіча|	Пузакоў Сяргей Валер’евіч
Раманоўскага Валерыя Віктаравіча|	Раманоўскі Валерый Віктаравіч
Рудніцкага Андрэя Аляксандравіча|	Рудніцкі Андрэй Аляксандравіч
Семяновіча Васілія Васільевіча|	Семяновіч Васілій Васільевіч
Сінякова Сяргея Аляксандравіча|	Сінякоў Сяргей Аляксандравіч
Сурава Вадзіма Аляксандравіча|	Сураў Вадзім Аляксандравіч
Фалько Аляксандра Анатольевіча|	Фалько Аляксандр Анатольевіч
Чарнабая Андрэя Іванавіча|	Чарнабай Андрэй Іванавіч
Шэлеста Рамана Сяргеевіча|	Шэлест Раман Сяргеевіч
Яніева Дзмітрыя Валер’евіча|	Яніеў Дзмітрый Валер’евіч
Бессмертнага Сяргея Філіпавіча|	Бессмертны Сяргей Філіпавіч
Дзіхцярука Дзяніса Мікалаевіча|	Дзіхцярук Дзяніс Мікалаевіч
Зубарава Сяргея Віктаравіча|	Зубараў Сяргей Віктаравіч
Казарана Льва Завенавіча|	Казаран Леў Завенавіч
Сакалова Вадзіма Барысавіча|	Сакалоў Вадзім Барысавіч
Старанцава Аляксея Сяргеевіча|	Старанцаў Аляксей Сяргеевіч
Саладуху Ілью Алегавіча|	Саладуха Ілья Алегавіч
Андрыевіча Мікалая Віктаравіча|	Андрыевіч Мікалай Віктаравіч
Арашкевіча Мікалая Уладзіміравіча|	Арашкевіч Мікалай Уладзіміравіч
Аўкапашвілі Аляксандра Дзмітрыевіча|	Аўкапашвілі Аляксандр Дзмітрыевіч
Блінкова Барыса Васільевіча|	Блінкоў Барыс Васільевіч
Вараву Ігара Алегавіча|	Варава Ігар Алегавіч
Варыцкага Ігара Уладзіміравіча|	Варыцкі Ігар Уладзіміравіч
Вечара Сяргея Сяргеевіча|	Вечар Сяргей Сяргеевіч
Гарэльскага Мікалая Валер’евіча|	Гарэльскі Мікалай Валер’евіч
Гулая Сяргея Валер’евіча|	Гулай Сяргей Валер’евіч
Дзержановіча Васілія Васільевіча|	Дзержановіч Васілій Васільевіч
Жыха Мікалая Аркадзьевіча|	Жых Мікалай Аркадзьевіч
Казакова Сяргея Данілавіча|	Казакоў Сяргей Данілавіч
Казлова Віктара Алегавіча|	Казлоў Віктар Алегавіч
Каліноўскага Сяргея Мікалаевіча|	Каліноўскі Сяргей Мікалаевіч
Катлярова Віталія Анатольевіча|	Катляроў Віталій Анатольевіч
Кірпічэнку Андрэя Пятровіча|	Кірпічэнка Андрэй Пятровіч
Кузьмянка Мікалая Іванавіча|	Кузьмянок Мікалай Іванавіч
Ліпко Дзмітрыя Віктаравіча|	Ліпко Дзмітрый Віктаравіч
Ліса Дзмітрыя Міхайлавіча|	Ліс Дзмітрый Міхайлавіч
Маісеева Дзмітрыя Канстанцінавіча|	Маісееў Дзмітрый Канстанцінавіч
Макоўскага Германа Мар’янавіча|	Макоўскі Герман Мар’янавіч
Мароза Андрэя Расціслававіча|	Мароз Андрэй Расціслававіч
Некраша Юрыя Уладзіміравіча|	Некраш Юрый Уладзіміравіч
Панасюка Леаніда Данілавіча|	Панасюк Леанід Данілавіч
Пляханава Мікалая Мікалаевіча|	Пляханаў Мікалай Мікалаевіч
Рудова Сяргея Станіслававіча|	Рудоў Сяргей Станіслававіч
Саўчанку Аляксандра Мікалаевіча|	Саўчанка Аляксандр Мікалаевіч
Серадзінскага Сяргея Віктаравіча|	Серадзінскі Сяргей Віктаравіч
Сівашынскага Эдуарда Віктаравіча|	Сівашынскі Эдуард Віктаравіч
Смаляка Барыса Дзмітрыевіча|	Смаляк Барыс Дзмітрыевіч
Стаселовіча Аляксандра Аляксеевіча|	Стаселовіч Аляксандр Аляксеевіч
Сяргеенку Андрэя Васільевіча|	Сяргеенка Андрэй Васільевіч
Трацюка Эдуарда Іванавіча|	Трацюк Эдуард Іванавіч
Усенку Мікалая Уладзіміравіча|	Усенка Мікалай Уладзіміравіч
Хільмановіча Алега Фёдаравіча|	Хільмановіч Алег Фёдаравіч
Цаноўскага Міхаіла Яўгеньевіча|	Цаноўскі Міхаіл Яўгеньевіч
Шыманскага Аляксандра Багданавіча|	Шыманскі Аляксандр Багданавіч
Шэўчыка Канстанціна Сяргеевіча|	Шэўчык Канстанцін Сяргеевіч
Янчыка Уладзіміра Анатольевіча|	Янчык Уладзімір Анатольевіч
Ярашэвіча Віктара Вячаслававіча|	Ярашэвіч Віктар Вячаслававіч
Аднаблюдаву Іну Ягораўну|	Аднаблюдава Іна Ягораўна
Анікееву Марыну Яўгенаўну|	Анікеева Марына Яўгенаўна
Апаланюка Сяргея Мікалаевіча|	Апаланюк Сяргей Мікалаевіч
Арцем’ева Валерыя Паўлавіча|	Арцем’еў Валерый Паўлавіч
Бачкова Канстанціна Афанасьевіча|	Бачкоў Канстанцін Афанасьевіч
Булыгу Мікалая Мікалаевіча|	Булыга Мікалай Мікалаевіч
Бякетаву Ганну Веньямінаўну|	Бякетава Ганна Веньямінаўна
Валанцей Алену Фёдараўну|	Валанцей Алена Фёдараўна
Вараксу Юрыя Францішкавіча|	Варакса Юрый Францішкавіч
Гузень Алену Філіпаўну|	Гузень Алена Філіпаўна
Гурынава Паўла Кузміча|	Гурынаў Павел Кузміч
Добыша Мікалая Іванавіча|	Добыш Мікалай Іванавіч
Канюшкевіча Мікалая Сяргеевіча|	Канюшкевіч Мікалай Сяргеевіч
Карусейчыка Мікалая Іванавіча|	Карусейчык Мікалай Іванавіч
Карцеля Мікалая Іванавіча|	Карцель Мікалай Іванавіч
Корзуна Вячаслава Феліксавіча|	Корзун Вячаслаў Феліксавіч
Кулакоўскага Барыса Леанідавіча|	Кулакоўскі Барыс Леанідавіч
Куцага Васілія Іванавіча|	Куцы Васілій Іванавіч
Кушнірэнку Валерыя Сцяпанавіча|	Кушнірэнка Валерый Сцяпанавіч
Лакамкіна Віктара Андрэевіча|	Лакамкін Віктар Андрэевіч
Лысова Антона Іванавіча|	Лысоў Антон Іванавіч
Мароза Сяргея Віктаравіча|	Мароз Сяргей Віктаравіч
Мацкевіч Людмілу Пятроўну|	Мацкевіч Людміла Пятроўна
Мілановіч Наталлю Феадосьеўну|	Мілановіч Наталля Феадосьеўна
Міхайліна Васіля Іванавіча|	Міхайлін Васіль Іванавіч
Мядзведзева Рыгора Фёдаравіча|	Мядзведзеў Рыгор Фёдаравіч
Пугачова Сяргея Васільевіча|	Пугачоў Сяргей Васільевіч
Савіцкага Юрыя Васільевіча|	Савіцкі Юрый Васільевіч
Семчука Аркадзія Леанідавіча|	Семчук Аркадзій Леанідавіч
Тулаеву Надзею Леанідаўну|	Тулаева Надзея Леанідаўна
Турлюка Віктара Іосіфавіча|	Турлюк Віктар Іосіфавіч
Філіпповіч Тамару Уладзіміраўну|	Філіпповіч Тамара Уладзіміраўна
Хвайніцкага Мікалая Іванавіча|	Хвайніцкі Мікалай Іванавіч
Хвата Аляксандра Аркадз’евіча|	Хват Аляксандр Аркадз’евіч
Храпко Святлану Віктараўну|	Храпко Святлана Віктараўна
Шыманчука Канстанціна Баляслававіча|	Шыманчук Канстанцін Баляслававіч
Ялавога Івана Аляксандравіча|	Ялавог Іван Аляксандравіч
Барадулю Валянціна Аляксеевіча|	Барадуля Валянцін Аляксеевіч
Давідзюка Аляксандра Барысавіча|	Давідзюк Аляксандр Барысавіч
Еўтуховіча Сяргея Пятровіча|	Еўтуховіч Сяргей Пятровіч
Карпука Аляксандра Анатольевіча|	Карпук Аляксандр Анатольевіч
Касіловіча Сяргея Аляксандравіча|	Касіловіч Сяргей Аляксандравіч
Кацяка Валерыя Уладзіміравіча|	Кацяк Валерый Уладзіміравіч
Краўцова Міхаіла Міхайлавіча|	Краўцоў Міхаіл Міхайлавіч
Сіўца Алега Анатольевіча|	Сівец Алег Анатольевіч
Акуневіча Сяргея Анатольевіча|	Акуневіч Сяргей Анатольевіч
Баранава Вадзіма Аляксандравіча|	Баранаў Вадзім Аляксандравіч
Барыева Цімура Рызаевіча|	Барыеў Цімур Рызаевіч
Барысенку Вячаслава Рыгоравіча|	Барысенка Вячаслаў Рыгоравіч
Болатава Ігара Уладзіміравіча|	Болатаў Ігар Уладзіміравіч
Бычка Міхаіла Міхайлавіча|	Бычк Міхаіл Міхайлавіч
Валынца Алега Анатольевіча|	Валынец Алег Анатольевіч
Вярэніча Аляксандра Максімавіча|	Вярэніч Аляксандр Максімавіч
Ганчарэнку Сяргея Міхайлавіча|	Ганчарэнка Сяргей Міхайлавіч
Гінько Дзмітрыя Казіміравіча|	Гінько Дзмітрый Казіміравіч
Грабнюка Мікалая Мікалаевіча|	Грабнюк Мікалай Мікалаевіч
Грыня Вячаслава Анатольевіча|	Грынь Вячаслаў Анатольевіч
Грыцанка Уладзіміра Аляксандравіча|	Грыцанок Уладзімір Аляксандравіч
Грэбня Эдуарда Паўлавіча|	Грэбнь Эдуард Паўлавіч
Дайлідзёнка Ігара Аляксандравіча|	Дайлідзёнак Ігар Аляксандравіч
Дайнеку Міхаіла Міхайлавіча|	Дайнека Міхаіл Міхайлавіч
Дземчука Юрыя Андрэевіча|	Дземчук Юрый Андрэевіч
Драхлова Юрыя Мікалаевіча|	Драхлоў Юрый Мікалаевіч
Загародняга Анатолія Мікалаевіча|	Загародняг Анатолій Мікалаевіч
Івалгіну Наталлю Яўгенаўну|	Івалгіна Наталля Яўгенаўна
Каваленку Ігара Уладзіміравіча|	Каваленка Ігар Уладзіміравіч
Каляснёва Уладзіміра Васільевіча|	Каляснёў Уладзімір Васільевіч
Кантаровіча Аляксандра Ігаравіча|	Кантаровіч Аляксандр Ігаравіч
Кармазіна Паўла Мікалаевіча|	Кармазін Павел Мікалаевіч
Качур Алу Віктараўну|	Качур Ала Віктараўна
Куліпу Сяргея Лявонцьевіча|	Куліпа Сяргей Лявонцьевіч
Лапановіча Сяргея Васільевіча|	Лапановіч Сяргей Васільевіч
Лявонава Сяргея Мікалаевіча|	Лявонаў Сяргей Мікалаевіч
Ляшука Алега Аляксандравіча|	Ляшук Алег Аляксандравіч
Макарэвіча Уладзіміра Міхайлавіча|	Макарэвіч Уладзімір Міхайлавіч
Марозава Віктара Мікалаевіча|	Марозаў Віктар Мікалаевіч
Мірончыка Аляксандра Сяргеевіча|	Мірончык Аляксандр Сяргеевіч
Наскевіча Івана Данілавіча|	Наскевіч Іван Данілавіч
Пракапчук Ларысу Юр’еўну|	Пракапчук Ларыса Юр’еўна
Прудчанку Аляксандра Віктаравіча|	Прудчанка Аляксандр Віктаравіч
Радзько Пятра Сцяпанавіча|	Радзько Пётр Сцяпанавіч
Саенку Аляксандра Аляксандравіча|	Саенка Аляксандр Аляксандравіч
Салодкіна Руслана Анатольевіча|	Салодкін Руслан Анатольевіч
Сароку Віталія Анатольевіча|	Сарока Віталій Анатольевіч
Сетунова Леаніда Юр’евіча|	Сетуноў Леанід Юр’евіч
Сідарэнку Аляксандра Дзмітрыевіча|	Сідарэнка Аляксандр Дзмітрыевіч
Скрыпнікава Дзмітрыя Мікалаевіча|	Скрыпнікаў Дзмітрый Мікалаевіч
Смірнова Аляксея Генадзьевіча|	Смірноў Аляксей Генадзьевіч
Стужынскага Дзмітрыя Антонавіча|	Стужынскі Дзмітрый Антонавіч
Транькова Аляксандра Уладзіміравіча|	Транькоў Аляксандр Уладзіміравіч
Федаровіча Аляксандра Міхайлавіча|	Федаровіч Аляксандр Міхайлавіч
Хабарава Уладзіміра Аляксандравіча|	Хабараў Уладзімір Аляксандравіч
Хвасько Віктара Жоржавіча|	Хвасько Віктар Жоржавіч
Цвірко Яўгена Уладзіміравіча|	Цвірко Яўген Уладзіміравіч
Юркевіч Тамару Іванаўну|	Юркевіч Тамара Іванаўна
Акімава Мікалая Мікалаевіча|	Акімаў Мікалай Мікалаевіч
Аксюціча Эдуарда Рыгоравіча|	Аксюціч Эдуард Рыгоравіч
Алейніка Аляксандра Генадзьевіча|	Алейнік Аляксандр Генадзьевіч
Александрова Дзмітрыя Аляксандравіча|	Александроў Дзмітрый Аляксандравіч
Аленскага Сяргея Сяргеевіча|	Аленскі Сяргей Сяргеевіч
Антонава Сяргея Анатольевіча|	Антонаў Сяргей Анатольевіч
Антоніка Уладзіміра Уладзіміравіча|	Антонік Уладзімір Уладзіміравіч
Анціпенку Дзмітрыя Анатольевіча|	Анціпенка Дзмітрый Анатольевіч
Аскеру Аляксандра Уладзіміравіча|	Аскера Аляксандр Уладзіміравіч
Асташова Сяргея Аляксандравіча|	Асташоў Сяргей Аляксандравіч
Бабічава Андрэя Паўлавіча|	Бабічаў Андрэй Паўлавіч
Багамолаву Ірыну Аляксандраўну|	Багамолава Ірына Аляксандраўна
Барана Аляксандра Аркадзьевіча|	Баран Аляксандр Аркадзьевіч
Баранава Аляксандра Іванавіча|	Баранаў Аляксандр Іванавіч
Барткевіч Ірыну Рыгораўну|	Барткевіч Ірына Рыгораўна
Барысенку Аляксандра Уладзіміравіча|	Барысенка Аляксандр Уладзіміравіч
Бастрыкава Алега Аляксандравіча|	Бастрыкаў Алег Аляксандравіч
Безабразаву Святлану Рыгораўну|	Безабразава Святлана Рыгораўна
Белазорава Аляксандра Мікалаевіча|	Белазораў Аляксандр Мікалаевіч
Белянкова Андрэя Аляксандравіча|	Белянкоў Андрэй Аляксандравіч
Беспалага Аляксандра Алегавіча|	Беспалы Аляксандр Алегавіч
Більмона Яўгенія Вітольдавіча|	Більмон Яўгеній Вітольдавіч
Благуна Генадзія Іванавіча|	Благун Генадзій Іванавіч
Богдана Аляксандра Мікалаевіча|	Богдан Аляксандр Мікалаевіч
Богдана Аляксандра Канстанцінавіча|	Богдан Аляксандр Канстанцінавіч
Брагінца Андрэя Іванавіча|	Брагінец Андрэй Іванавіч
Будзько Віктара Браніслававіча|	Будзько Віктар Браніслававіч
Булюхіна Аляксандра Сяргеевіча|	Булюхін Аляксандр Сяргеевіч
Буняка Віталія Міхайлавіча|	Буняк Віталій Міхайлавіч
Бурдука Сяргея Міхайлавіча|	Бурдук Сяргей Міхайлавіч
Бутрыма Алега Анатольевіча|	Бутрым Алег Анатольевіч
Буцько Міхаіла Уладзіміравіча|	Буцько Міхаіл Уладзіміравіч
Быкаву Ірыну Валянцінаўну|	Быкава Ірына Валянцінаўна
Вакуліча Алега Рыгоравіча|	Вакуліч Алег Рыгоравіч
Вакульчыка Аляксандра Віктаравіча|	Вакульчык Аляксандр Віктаравіч
Валынца Васілія Мікалаевіча|	Валынец Васілій Мікалаевіч
Віткоўскага Вячаслава Станіслававіча|	Віткоўскі Вячаслаў Станіслававіч
Войціка Сяргея Фёдаравіча|	Войцік Сяргей Фёдаравіч
Волкаву Ірыну Васільеўну|	Волкава Ірына Васільеўна
Волчыка Дзмітрыя Мікалаевіча|	Волчык Дзмітрый Мікалаевіч
Вышэдка Карыну Эдуардаўну|	Вышэдка Карына Эдуардаўна
Вярэніча Аляксандра Міхайлавіча|	Вярэніч Аляксандр Міхайлавіч
Галамаку Ігара Мікалаевіча|	Галамака Ігар Мікалаевіч
Галенкова Уладзіміра Уладзіміравіча|	Галенкоў Уладзімір Уладзіміравіч
Гапоненку Міхаіла Іванавіча|	Гапоненка Міхаіл Іванавіч
Гарбузава Аляксандра Віктаравіча|	Гарбузаў Аляксандр Віктаравіч
Гаркаўца Аляксандра Станіслававіча|	Гаркавец Аляксандр Станіслававіч
Гарыцкага Канстанціна Уладзіміравіча|	Гарыцкі Канстанцін Уладзіміравіч
Гаўрыленка Ірыну Цімафееўну|	Гаўрыленка Ірына Цімафееўна
Герашчанку Мікалая Мікалаевіча|	Герашчанка Мікалай Мікалаевіч
Глушчанку Руслана Уладзіміравіча|	Глушчанка Руслан Уладзіміравіч
Голубева Аляксандра Валер’евіча|	Голубеў Аляксандр Валер’евіч
Гонтарава Андрэя Анатольевіча|	Гонтараў Андрэй Анатольевіч
Гормаша Сяргея Сяргеевіча|	Гормаш Сяргей Сяргеевіч
Грамузава Аляксандра Аркадзьевіча|	Грамузаў Аляксандр Аркадзьевіч
Грыбко Сяргея Мікалаевіча|	Грыбко Сяргей Мікалаевіч
Грыня Віталія Васільевіча|	Грынь Віталій Васільевіч
Грышчанку Аляксандра Аляксандравіча|	Грышчанка Аляксандр Аляксандравіч
Грэфа Віталія Канстанцінавіча|	Грэф Віталій Канстанцінавіч
Гульмантовіча Анжэя Славаміравіча|	Гульмантовіч Анжэй Славаміравіч
Гуляшку Уладзіміра Іосіфавіча|	Гуляшка Уладзімір Іосіфавіч
Дайлідку Уладзіміра Рышардавіча|	Дайлідка Уладзімір Рышардавіч
Дарасевіч Таццяну Віктараўну|	Дарасевіч Таццяна Віктараўна
Дарашкевіча Вадзіма Міхайлавіча|	Дарашкевіч Вадзім Міхайлавіч
Дароўка Валянціну Уладзіміраўну|	Дароўка Валянціна Уладзіміраўна
Даўлюда Аляксандра Аляксандравіча|	Даўлюд Аляксандр Аляксандравіч
Драпко Міхаіла Уладзіміравіча|	Драпко Міхаіл Уладзіміравіч
Дробава Аляксандра Аляксандравіча|	Дробаў Аляксандр Аляксандравіч
Ермаковіча Анатоля Анатольевіча|	Ермаковіч Анатоль Анатольевіч
Ермачонка Аляксандра Уладзіміравіча|	Ермачонак Аляксандр Уладзіміравіч
Ермоленка Наталлю Міхайлаўну|	Ермоленка Наталля Міхайлаўна
Жаўнова Алега Рыгоравіча|	Жаўноў Алег Рыгоравіч
Жорава Сяргея Анатольевіча|	Жораў Сяргей Анатольевіч
Жукоўскага Андрэя Міхайлавіча|	Жукоўскі Андрэй Міхайлавіч
Жылінскага Андрэя Аляксандравіча|	Жылінскі Андрэй Аляксандравіч
Загорскага Васілія Васільевіча|	Загорскі Васілій Васільевіч
Заеца Уладзіміра Мікалаевіча|	Заец Уладзімір Мікалаевіч
Зайцава Ігара Іванавіча|	Зайцаў Ігар Іванавіч
Зайцава Юрыя Міхайлавіча|	Зайцаў Юрый Міхайлавіч
Замару Івана Браніслававіча|	Замара Іван Браніслававіч
Замойскую Веру Максімаўну|	Замойская Вера Максімаўна
Зароўскага Юрыя Анатольевіча|	Зароўскі Юрый Анатольевіч
Захарава Сяргея Рыгоравіча|	Захараў Сяргей Рыгоравіч
Іванекіна Аляксандра Мікалаевіча|	Іванекін Аляксандр Мікалаевіч
Іванова Сяргея Анатольевіча|	Іваноў Сяргей Анатольевіч
Іванова Уладзіміра Мікалаевіча|	Іваноў Уладзімір Мікалаевіч
Ільючыка Віталія Валянцінавіча|	Ільючык Віталій Валянцінавіч
Каваленку Паўла Анатольевіча|	Каваленка Павел Анатольевіч
Казакова Уладзіміра Валянцінавіча|	Казакоў Уладзімір Валянцінавіч
Казея Аляксандра Анатольевіча|	Казей Аляксандр Анатольевіч
Каленіка Віталія Віктаравіча|	Каленік Віталій Віктаравіч
Кальцова Аляксандра Яўгеньевіча|	Кальцоў Аляксандр Яўгеньевіч
Каляду Кірыла Генадзьевіча|	Каляда Кірыл Генадзьевіч
Камарэнку Сяргея Віктаравіча|	Камарэнка Сяргей Віктаравіч
Камоску Андрэя Уладзіміравіча|	Камоска Андрэй Уладзіміравіч
Канакова Генадзія Паўлавіча|	Канакоў Генадзій Паўлавіч
Кандзеру Аляксандра Васільевіча|	Кандзера Аляксандр Васільевіч
Кандрацьеву Жанну Барысаўну|	Кандрацьева Жанна Барысаўна
Капусціна Аляксандра Рыгоравіча|	Капусцін Аляксандр Рыгоравіч
Капылова Аляксея Іванавіча|	Капылоў Аляксей Іванавіч
Карасёва Уладзіміра Васільевіча|	Карасёў Уладзімір Васільевіч
Караткова Аляксея Мікалаевіча|	Караткоў Аляксей Мікалаевіч
Карлашова Дзмітрыя Мікалаевіча|	Карлашоў Дзмітрый Мікалаевіч
Касоўскага Дзмітрыя Яраслававіча|	Касоўскі Дзмітрый Яраслававіч
Каўрэцкага Валерыя Фёдаравіча|	Каўрэцкі Валерый Фёдаравіч
Кірэенку Пятра Мікалаевіча|	Кірэенка Пётр Мікалаевіч
Клезовіча Сяргея Іванавіча|	Клезовіч Сяргей Іванавіч
Клімчук Вольгу Іосіфаўну|	Клімчук Вольга Іосіфаўна
Коваля Васіля Міхайлавіча|	Коваль Васіль Міхайлавіч
Коваля Пятра Паўлавіча|	Коваль Пётр Паўлавіч
Козела Ігара Іванавіча|	Козел Ігар Іванавіч
Козіча Аляксандра Аляксандравіча|	Козіч Аляксандр Аляксандравіч
Кошкіна Ілью Віктаравіча|	Кошкін Ілья Віктаравіч
Краўчука Ігара Васільевіча|	Краўчук Ігар Васільевіч
Крука Дзяніса Уладзіміравіча|	Крук Дзяніс Уладзіміравіч
Крупенку Дзмітрыя Віктаравіча|	Крупенка Дзмітрый Віктаравіч
Крыкун Людмілу Мікалаеўну|	Крыкун Людміла Мікалаеўна
Кулікова Аляксандра Яўгеньевіча|	Кулікоў Аляксандр Яўгеньевіч
Куніцкага Паўла Аляксандравіча|	Куніцкі Павел Аляксандравіч
Куратніка Эдуарда Леанідавіча|	Куратнік Эдуард Леанідавіч
Курылкіну Алену Паўлаўну|	Курылкіна Алена Паўлаўна
Кухарэнку Аляксандра Міхайлавіча|	Кухарэнка Аляксандр Міхайлавіч
Кучарэнку Віктара Анатольевіча|	Кучарэнка Віктар Анатольевіч
Кучынскага Генадзія Часлававіча|	Кучынскі Генадзій Часлававіч
Лагуна Вячаслава Анатольевіча|	Лагун Вячаслаў Анатольевіч
Лапушкіна Сяргея Уладзіміравіча|	Лапушкін Сяргей Уладзіміравіч
Ларычава Віктара Юр’евіча|	Ларычаў Віктар Юр’евіч
Леўчанку Уладзіслава Васільевіча|	Леўчанка Уладзіслаў Васільевіч
Ліпскага Валерыя Міхайлавіча|	Ліпскі Валерый Міхайлавіч
Літвінава Андрэя Уладзіміравіча|	Літвінаў Андрэй Уладзіміравіч
Лукашэвіча Станіслава Вацлававіча|	Лукашэвіч Станіслаў Вацлававіч
Лукуця Андрэя Георгіевіча|	Лукуць Андрэй Георгіевіч
Лушчыка Паўла Міхайлавіча|	Лушчык Павел Міхайлавіч
Лябецкага Валерыя Уладзіміравіча|	Лябецкі Валерый Уладзіміравіч
Ляхава Антона Генадзьевіча|	Ляхаў Антон Генадзьевіч
Майсеенку Аляксандра Яўгеньевіча|	Майсеенка Аляксандр Яўгеньевіч
Макарава Аляксандра Юрьевіча|	Макараў Аляксандр Юрьевіч
Макарук Маргарыту Канстанцінаўну|	Макарук Маргарыта Канстанцінаўна
Макарэвіча Андрэя Пятровіча|	Макарэвіч Андрэй Пятровіч
Малашанку Сяргея Міхайлавіча|	Малашанка Сяргей Міхайлавіч
Маліноўскага Аляксандра Мікалаевіча|	Маліноўскі Аляксандр Мікалаевіч
Марашчука Віталія Вячаслававіча|	Марашчук Віталій Вячаслававіч
Маркава Аляксандра Мікалаевіча|	Маркаў Аляксандр Мікалаевіч
Масальскага Віталія Іванавіча|	Масальскі Віталій Іванавіч
Мацкевіча Іосіфа Феліксавіча|	Мацкевіч Іосіф Феліксавіч
Мельнікава Івана Уладзіміравіча|	Мельнікаў Іван Уладзіміравіч
Менько Паўла Іосіфавіча|	Менько Павел Іосіфавіч
Мікавоза Валерыя Генадзьевіча|	Мікавоз Валерый Генадзьевіч
Місіюка Андрэя Рыгоравіча|	Місіюк Андрэй Рыгоравіч
Музыку Сяргея Анатольевіча|	Музыка Сяргей Анатольевіч
Мусніцкага Івана Пятровіча|	Мусніцкі Іван Пятровіч
Мядзведзева Уладзіміра Анатольевіча|	Мядзведзеў Уладзімір Анатольевіч
Мяцейку Алега Іванавіча|	Мяцейка Алег Іванавіч
Наздрына Максіма Уладзіміравіча|	Наздрын Максім Уладзіміравіч
Находка Таццяну Уладзіміраўну|	Находка Таццяна Уладзіміраўна
Некрашэвіча Аляксандра Раманавіча|	Некрашэвіч Аляксандр Раманавіч
Несцяровіча Ігара Віктаравіча|	Несцяровіч Ігар Віктаравіч
Нікалаенка Наталлю Міхайлаўну|	Нікалаенка Наталля Міхайлаўна
Нікітачкіна Яўгенія Леанідавіча|	Нікітачкін Яўгеній Леанідавіч
Новікава Анатолія Анатольевіча|	Новікаў Анатолій Анатольевіч
Нядвецкага Сяргея Віктаравіча|	Нядвецкі Сяргей Віктаравіч
Палтаўцаву Алену Валер’еўну|	Палтаўцава Алена Валер’еўна
Панкова Вячаслава Мікалаевіча|	Панкоў Вячаслаў Мікалаевіч
Паржона Аляксандра Адамавіча|	Паржон Аляксандр Адамавіч
Парфянкова Сяргея Мікалаевіча|	Парфянкоў Сяргей Мікалаевіч
Паўлюковіча Васілія Васільевіча|	Паўлюковіч Васілій Васільевіч
Пашкевіча Максіма Генадзьевіча|	Пашкевіч Максім Генадзьевіч
Перапечку Мікалая Мікалаевіча|	Перапечка Мікалай Мікалаевіч
Петрашкевіч Таццяну Уладзіміраўну|	Петрашкевіч Таццяна Уладзіміраўна
Пікузу Уладзіміра Мікалаевіча|	Пікуза Уладзімір Мікалаевіч
Пікулеву Ліяну Мікалаеўну|	Пікулева Ліяна Мікалаеўна
Пінчукова Алега Аляксеевіча|	Пінчукоў Алег Аляксеевіч
Поташа Андрэя Уладзіміравіча|	Поташ Андрэй Уладзіміравіч
Пражко Наталлю Мікалаеўну|	Пражко Наталля Мікалаеўна
Пракопа Андрэя Казіміравіча|	Пракоп Андрэй Казіміравіч
Прыгунова Мікалая Віктаравіча|	Прыгуноў Мікалай Віктаравіч
Прыльскага Віталія Мікалаевіча|	Прыльскі Віталій Мікалаевіч
Пыжову Вольгу Сцяпанаўну|	Пыжова Вольга Сцяпанаўна
Пыко Таццяну Іванаўну|	Пыко Таццяна Іванаўна
Пятніцкага Дзяніса Аляксандравіча|	Пятніцкі Дзяніс Аляксандравіч
Пятрова Сяргея Анатольевіча|	Пятроў Сяргей Анатольевіч
Рабінава Вадзіма Артуравіча|	Рабінаў Вадзім Артуравіч
Рагоўскага Андрэя Сямёнавіча|	Рагоўскі Андрэй Сямёнавіч
Радчанку Дзмітрыя Міхайлавіча|	Радчанка Дзмітрый Міхайлавіч
Разумовіча Сяргея Аляксандравіча|	Разумовіч Сяргей Аляксандравіч
Раманюка Дзмітрыя Яўгеньевіча|	Раманюк Дзмітрый Яўгеньевіч
Рашэтнікава Міхаіла Мікалаевіча|	Рашэтнікаў Міхаіл Мікалаевіч
Роўбу Валерыя Бернардавіча|	Роўба Валерый Бернардавіч
Румачыка Альберта Мікалаевіча|	Румачык Альберт Мікалаевіч
Рыжука Івана Іванавіча|	Рыжук Іван Іванавіч
Савасцюка Сяргея Іванавіча|	Савасцюк Сяргей Іванавіч
Савіцкага Сяргея Яўгенавіча|	Савіцкі Сяргей Яўгенавіч
Садаўнічага Аляксандра Сяргеевіча|	Садаўнічы Аляксандр Сяргеевіч
Саковіча Дзмітрыя Мікалаевіча|	Саковіч Дзмітрый Мікалаевіч
Саковіча Юрыя Леанідавіча|	Саковіч Юрый Леанідавіч
Саломкіна Сяргея Валянцінавіча|	Саломкін Сяргей Валянцінавіч
Салу Уладзіміра Вацлававіча|	Сала Уладзімір Вацлававіч
Самца Валерыя Барысавіча|	Самц Валерый Барысавіч
Санчука Андрэя Уладзіміравіча|	Санчук Андрэй Уладзіміравіч
Сарокіна Аляксандра Валер’евіча|	Сарокін Аляксандр Валер’евіч
Сверэпу Канстанціна Канстанцінавіча|	Сверэпа Канстанцін Канстанцінавіч
Севасцьянава Віталія Анатольевіча|	Севасцьянаў Віталій Анатольевіч
Семашка Алену Валер’еўну|	Семашка Алена Валер’еўна
Сівянка Андрэя Уладзіміравіча|	Сівянок Андрэй Уладзіміравіч
Сідарэнку Аляксандра Васільевіча|	Сідарэнка Аляксандр Васільевіч
Скварцова Дзяніса Аляксеевіча|	Скварцоў Дзяніс Аляксеевіч
Смаленскага Сяргея Францавіча|	Смаленскі Сяргей Францавіч
Спасюка Андрэя Вячаслававіча|	Спасюк Андрэй Вячаслававіч
Станішэўскага Уладзіміра Васільевіча|	Станішэўскі Уладзімір Васільевіч
Старавойта Дзяніса Аляксандравіча|	Старавойт Дзяніс Аляксандравіч
Старасціна Алега Эдуардавіча|	Старасцін Алег Эдуардавіч
Страчука Аляксандра Пятровіча|	Страчук Аляксандр Пятровіч
Сугако Сяргея Васільевіча|	Сугако Сяргей Васільевіч
Суліму Уладзіміра Уладзіміравіча|	Суліма Уладзімір Уладзіміравіч
Сцёпачкіна Аляксандра Аляксеевіча|	Сцёпачкін Аляксандр Аляксеевіч
Сямашку Мікалая Мікалаевіча|	Сямашка Мікалай Мікалаевіч
Таўгеня Івана Канстанцінавіча|	Таўгень Іван Канстанцінавіч
Трэбухоўскага Алега Рычардавіча|	Трэбухоўскі Алег Рычардавіч
Тужыка Алега Мікалаевіча|	Тужык Алег Мікалаевіч
Федарчука Віталія Аляксандравіча|	Федарчук Віталій Аляксандравіч
Фёдарава Андрэя Уладзіміравіча|	Фёдараў Андрэй Уладзіміравіч
Філіну Алену Леанідаўну|	Філіна Алена Леанідаўна
Хадановіча Аляксандра Эдуардавіча|	Хадановіч Аляксандр Эдуардавіч
Хацука Дзмітрыя Міхайлавіча|	Хацук Дзмітрый Міхайлавіч
Хвасько Юрыя Міхайлавіча|	Хвасько Юрый Міхайлавіч
Хілеўскага Андрэя Станіслававіча|	Хілеўскі Андрэй Станіслававіч
Хлабукіна Ігара Канстанцінавіча|	Хлабукін Ігар Канстанцінавіч
Цімафеева Уладзіміра Глебавіча|	Цімафееў Уладзімір Глебавіч
Ціханава Яўгенія Анатольевіча|	Ціханаў Яўгеній Анатольевіч
Цяпло Ігара Аляксандравіча|	Цяпло Ігар Аляксандравіч
Цярэнцьева Івана Пятровіча|	Цярэнцьеў Іван Пятровіч
Чайка Таццяну Мікалаеўну|	Чайка Таццяна Мікалаеўна
Чарнавалода Максіма Анатольевіча|	Чарнавалод Максім Анатольевіч
Чарнавусіка Аляксандра Аркадзьевіча|	Чарнавусік Аляксандр Аркадзьевіч
Чарнякова Ігара Фёдаравіча|	Чарнякоў Ігар Фёдаравіч
Чмель Ларысу Уладзіміраўну|	Чмель Ларыса Уладзіміраўна
Чычыкайлу Алега Аляксандравіча|	Чычыкайла Алег Аляксандравіч
Шайтара Віктара Пятровіча|	Шайтар Віктар Пятровіч
Шаліка Дзмітрыя Іванавіча|	Шалік Дзмітрый Іванавіч
Шарапава Віталія Мікалаевіча|	Шарапаў Віталій Мікалаевіч
Шашко Аляксандра Іванавіча|	Шашко Аляксандр Іванавіч
Шкабару Паўла Аляксандравіча|	Шкабара Павел Аляксандравіч
Шкуцько Юрыя Аляксандравіча|	Шкуцько Юрый Аляксандравіч
Шматава Паўла Юр’евіча|	Шматаў Павел Юр’евіч
Шубцік Галіну Васільеўну|	Шубцік Галіна Васільеўна
Шумеля Аляксандра Генрыхавіча|	Шумель Аляксандр Генрыхавіч
Шчуру Сяргея Анатольевіча|	Шчура Сяргей Анатольевіч
Шчытнікава Сяргея Аляксандравіча|	Шчытнікаў Сяргей Аляксандравіч
Шышканаву Аляксандру Юр’еўну|	Шышканава Аляксандра Юр’еўна
Шышко Аляксандра Міхайлавіча|	Шышко Аляксандр Міхайлавіч
Шэхаўцова Андрэя Валер’евіча|	Шэхаўцоў Андрэй Валер’евіч
Юзвенку Уладзіміра Вячаслававіча|	Юзвенка Уладзімір Вячаслававіч
Юнцэвіча Аляксандра Фёдаравіча|	Юнцэвіч Аляксандр Фёдаравіч
Ягорава Аляксандра Міхайлавіча|	Ягораў Аляксандр Міхайлавіч
Язвінскага Яўгенія Уладзіміравіча|	Язвінскі Яўгеній Уладзіміравіч
Яруту Андрэя Паўлавіча|	Ярута Андрэй Паўлавіч
Яўсеенку Канстанціна Браніслававіча|	Яўсеенка Канстанцін Браніслававіч
Яўсеенку Сяргея Аляксеевіча|	Яўсеенка Сяргей Аляксеевіч
Яхімовіча Аляксандра Аляксандравіча|	Яхімовіч Аляксандр Аляксандравіч
Дабейка Вольгу Уладзіславаўну|	Дабейка Вольга Уладзіславаўна
Камянецкую Алену Мікалаеўну|	Камянецкая Алена Мікалаеўна
Кузьміч Алену Міхайлаўну|	Кузьміч Алена Міхайлаўна
Лобач Таццяну Іванаўну|	Лобач Таццяна Іванаўна
Мішкель Тэрэсу Генрыхаўну|	Мішкель Тэрэса Генрыхаўна
Абрамовіч Марыю Барысаўну|	Абрамовіч Марыя Барысаўна
Бондарэву Вераніку Сцяпанаўну|	Бондарэва Вераніка Сцяпанаўна
Гук Іну Анатольеўну|	Гук Іна Анатольеўна
Кармановіч Ірыну Аляксееўну|	Кармановіч Ірына Аляксееўна
Клімавец Галіну Іванаўну|	Клімавец Галіна Іванаўна
Ляшчынскую Людмілу Іосіфаўну|	Ляшчынская Людміла Іосіфаўна
Марусенка Таццяну Яўгеньеўну|	Марусенка Таццяна Яўгеньеўна
Міхайлік Таццяну Уладзіміраўну|	Міхайлік Таццяна Уладзіміраўна
Савіцкую Аксану Анатольеўну|	Савіцкая Аксана Анатольеўна
Спірыдонаву Любоў Раманаўну|	Спірыдонава Любоў Раманаўна
Сцепанюк Таццяну Міхайлаўну|	Сцепанюк Таццяна Міхайлаўна
Філіпаву Наталлю Міхайлаўну|	Філіпава Наталля Міхайлаўна
Дзямідаву Надзею Пятроўну|	Дзямідава Надзея Пятроўна
Савосценку Ігара Якаўлевіча|	Савосценка Ігар Якаўлевіч
Феакцістава Анатолія Мікалаевіча|	Феакцістаў Анатолій Мікалаевіч
Цішкову Наталлю Іванаўну|	Цішкова Наталля Іванаўна
Анфімава Леаніда Васільевіча|	Анфімаў Леанід Васільевіч
Вашкевіча Аляксандра Пятровіча|	Вашкевіч Аляксандр Пятровіч
Качаткову Ірыну Львоўну|	Качаткова Ірына Львоўна
Кухарэнка Ніну Іванаўну|	Кухарэнка Ніна Іванаўна
Рэбкаўца Валерыя Васільевіча|	Рэбкавец Валерый Васільевіч
Кількоўскую Ганну Антонаўну|	Кількоўская Ганна Антонаўна
Курлыпу Аляксандра Міхайлавіча|	Курлыпа Аляксандр Міхайлавіч
Куцапалаву Валянціну Іванаўну|	Куцапалава Валянціна Іванаўна
Лапцева Віктара Сяргеевіча|	Лапцеў Віктар Сяргеевіч
Мацуку Сяргея Канстанцінавіча|	Мацука Сяргей Канстанцінавіч
Пазняк Алу Вячаславаўну|	Пазняк Ала Вячаславаўна
Шавель Іну Давыдаўну|	Шавель Іна Давыдаўна
Ацясава Аляксандра Ягоравіча|	Ацясаў Аляксандр Ягоравіч
Гарбацэвіч Марыю Аляксандраўну|	Гарбацэвіч Марыя Аляксандраўна
Балейку Фёдара Фёдаравіча|	Балейка Фёдар Фёдаравіч
Галавацкага Генадзя Леанідавіча|	Галавацкі Генадзь Леанідавіч
Дубіну Аляксандра Уладзіміравіча|	Дубіна Аляксандр Уладзіміравіч
Жыбуртовіча Віктара Валянцінавіча|	Жыбуртовіч Віктар Валянцінавіч
Караева Юрыя Хаджымуратавіча|	Караеў Юрый Хаджымуратавіч
Лазаковіча Яўгенія Леанідавіча|	Лазаковіч Яўгеній Леанідавіч
Літвіна Юрыя Аляксандравіча|	Літвін Юрый Аляксандравіч
Ляговіча Альберта Геранімавіча|	Ляговіч Альберт Геранімавіч
Мельчанку Мікалая Аляксандравіча|	Мельчанка Мікалай Аляксандравіч
Нікіціна Эдуарда Анатольевіча|	Нікіцін Эдуард Анатольевіч
Ранцава Мікалая Пятровіча|	Ранцаў Мікалай Пятровіч
Сандалюка Сяргея Васільевіча|	Сандалюк Сяргей Васільевіч
Сямёнава Сяргея Уладзіміравіча|	Сямёнаў Сяргей Уладзіміравіч
Сянько Віктара Сяргеевіча|	Сянько Віктар Сяргеевіч
Ткачэнку Валянціна Збігневіча|	Ткачэнка Валянцін Збігневіч
Фядотава Вадзіма Валер’евіча|	Фядотаў Вадзім Валер’евіч
Цішкевіча Мікалая Карпавіча|	Цішкевіч Мікалай Карпавіч
Часнова Андрэя Анатольевіча|	Часноў Андрэй Анатольевіч
Чучкова Станіслава Грыгор’евіча|	Чучкоў Станіслаў Грыгор’евіч
Алферава Андрэя Іванавіча|	Алфераў Андрэй Іванавіч
Адамовіча Аляксандра Уладзіміравіча|	Адамовіч Аляксандр Уладзіміравіч
Аляксеева Андрыса Пранасавіча|	Аляксееў Андрыс Пранасавіч
Анішчанка Інесу Аляксееўну|	Анішчанка Інеса Аляксееўна
Бібікаву Таццяну Іванаўну|	Бібікава Таццяна Іванаўна
Бруснікава Анжэя Барысавіча|	Бруснікаў Анжэй Барысавіч
Вараб’ёва Юрыя Анатольевіча|	Вараб’ёў Юрый Анатольевіч
Васільева Анатолія Анатольевіча|	Васільеў Анатолій Анатольевіч
Галавача Сяргея Аляксандравіча|	Галавач Сяргей Аляксандравіч
Далідовіча Аляксандра Уладзіміравіча|	Далідовіч Аляксандр Уладзіміравіч
Дарошку Сяргея Анатольевіча|	Дарошка Сяргей Анатольевіч
Дзмітрука Аляксандра Мікалаевіча|	Дзмітрук Аляксандр Мікалаевіч
Дзянісава Алега Уладзіміравіча|	Дзянісаў Алег Уладзіміравіч
Дубоўскага Андрэя Міхайлавіча|	Дубоўскі Андрэй Міхайлавіч
Емельянава Андрэя Анатольевіча|	Емельянаў Андрэй Анатольевіч
Ермалаева Аляксандра Уладзіміравіча|	Ермалаеў Аляксандр Уладзіміравіч
Жоглу Віталія Аляксандравіча|	Жогла Віталій Аляксандравіч
Кабранава Міхаіла Паўлавіча|	Кабранаў Міхаіл Паўлавіч
Кавальчука Аляксандра Аляксандравіча|	Кавальчук Аляксандр Аляксандравіч
Лазінскага Уладзіміра Дзмітрыевіча|	Лазінскі Уладзімір Дзмітрыевіч
Лісімава Аляксандра Фёдаравіча|	Лісімаў Аляксандр Фёдаравіч
Лысака Канстанціна Канстанцінавіча|	Лысак Канстанцін Канстанцінавіч
Лянько Васілія Іванавіча|	Лянько Васілій Іванавіч
Мамедава Руслана Валер’евіча|	Мамедаў Руслан Валер’евіч
Мутоўкіну Наталлю Веньямінаўну|	Мутоўкіна Наталля Веньямінаўна
Мыкуша Юрыя Фёдаравіча|	Мыкуш Юрый Фёдаравіч
Нікіціна Леаніда Леанідавіча|	Нікіцін Леанід Леанідавіч
Паздзеева Ігара Анатольевіча|	Паздзееў Ігар Анатольевіч
Пасечнага Аляксея Вітальевіча|	Пасечны Аляксей Вітальевіч
Пашвенчука Валерыя Арсенцьевіча|	Пашвенчук Валерый Арсенцьевіч
Пашкова Ігара Міхайлавіча|	Пашкоў Ігар Міхайлавіч
Петрана Аляксандра Сяргеевіча|	Петран Аляксандр Сяргеевіч
Раманава Максіма Барысавіча|	Раманаў Максім Барысавіч
Рахманава Аляксандра Аляксандравіча|	Рахманаў Аляксандр Аляксандравіч
Сільчанку Анатолія Міхайлавіча|	Сільчанка Анатолій Міхайлавіч
Собалева Сяргея Віктаравіча|	Собалеў Сяргей Віктаравіч
Ткача Ігара Уладзіміравіча|	Ткач Ігар Уладзіміравіч
Тымуля Дзмітрыя Станіслававіча|	Тымуль Дзмітрый Станіслававіч
Філюту Аляксандра Іванавіча|	Філюта Аляксандр Іванавіч
Хіхола Руслана Аляксандравіча|	Хіхол Руслан Аляксандравіч
Хрыпача Сяргея Уладзіміравіча|	Хрыпач Сяргей Уладзіміравіч
Цімафеева Віталія Мікалаевіча|	Цімафееў Віталій Мікалаевіч
Шаўлюкевіча Уладзіміра Леанідавіча|	Шаўлюкевіч Уладзімір Леанідавіч
Шышова Сяргея Іванавіча|	Шышоў Сяргей Іванавіч
Агародніка Віталія Барысавіча|	Агароднік Віталій Барысавіч
Алейніка Сяргея Міхайлавіча|	Алейнік Сяргей Міхайлавіч
Аліевіч Вольгу Мікалаеўну|	Аліевіч Вольга Мікалаеўна
Альхімовіча Віктара Эдуардавіча|	Альхімовіч Віктар Эдуардавіч
Ананіча Аляксандра Іванавіча|	Ананіч Аляксандр Іванавіч
Анашку Аляксея Славаміравіча|	Анашка Аляксей Славаміравіч
Андрукевіча Уладзіміра Мар’янавіча|	Андрукевіч Уладзімір Мар’янавіч
Анішчанку Аляксандра Валянцінавіча|	Анішчанка Аляксандр Валянцінавіч
Анішчанку Мікалая Уладзіміравіча|	Анішчанка Мікалай Уладзіміравіч
Арлоўскую Наталлю Ігараўну|	Арлоўская Наталля Ігараўна
Арсеньеву Софію Іванаўну|	Арсеньева Софія Іванаўна
Атрошчанку Уладзіміра Васільевіча|	Атрошчанка Уладзімір Васільевіч
Аўсіевіча Сяргея Аляксандравіча|	Аўсіевіч Сяргей Аляксандравіч
Баброву Святлану Мікалаеўну|	Баброва Святлана Мікалаеўна
Багданава Аляксандра Валер’евіча|	Багданаў Аляксандр Валер’евіч
Бадунова Аляксандра Іванавіча|	Бадуноў Аляксандр Іванавіч
Баенскага Сяргея Васільевіча|	Баенскі Сяргей Васільевіч
Базана Андрэя Генадзьевіча|	Базан Андрэй Генадзьевіч
Байцова Аляксандра Уладзіміравіча|	Байцоў Аляксандр Уладзіміравіч
Балашэнку Андрэя Канстанцінавіча|	Балашэнка Андрэй Канстанцінавіч
Баравіка Сяргея Міхайлавіча|	Баравік Сяргей Міхайлавіч
Барадунова Вадзіма Яўгеньевіча|	Барадуноў Вадзім Яўгеньевіч
Барысава Валерыя Яўгеньевіча|	Барысаў Валерый Яўгеньевіч
Барысюка Уладзіміра Цярэнцьевіча|	Барысюк Уладзімір Цярэнцьевіч
Башуна Сяргея Анатольевіча|	Башун Сяргей Анатольевіч
Белагаловага Уладзіміра Станіслававіча|	Белагаловы Уладзімір Станіслававіч
Бортніка Ігара Мікалаевіча|	Бортнік Ігар Мікалаевіч
Булаўкіна Паўла Уладзіміравіча|	Булаўкін Павел Уладзіміравіч
Бут-Гусаіма Аляксандра Фёдаравіча|	Бут-Гусаім Аляксандр Фёдаравіч
Быба Леаніда Рыгоравіча|	Быб Леанід Рыгоравіч
Бянькоўскага Віктара Казіміравіча|	Бянькоўскі Віктар Казіміравіч
Вабішчэвіча Валерыя Леанідавіча|	Вабішчэвіч Валерый Леанідавіч
Важгурава Віктара Віктаравіча|	Важгураў Віктар Віктаравіч
Валаха Альберта Мікалаевіча|	Валах Альберт Мікалаевіч
Валодзіна Яўгенія Уладзіміравіча|	Валодзін Яўгеній Уладзіміравіч
Васільку Іосіфа Іосіфавіча|	Васілька Іосіф Іосіфавіч
Васьковіча Андрэя Уладзіміравіча|	Васьковіч Андрэй Уладзіміравіч
Велясніцкага Ігара Мікалаевіча|	Велясніцкі Ігар Мікалаевіч
Вышынскага Віталія Аляксандравіча|	Вышынскі Віталій Аляксандравіч
Вяршыну Сяргея Іпалітавіча|	Вяршына Сяргей Іпалітавіч
Галавача Івана Яўгеньевіча|	Галавач Іван Яўгеньевіч
Галатко Сяргея Іванавіча|	Галатко Сяргей Іванавіч
Галуца Віктара Мікалаевіча|	Галуц Віктар Мікалаевіч
Ганчарэвіча Віктара Георгіевіча|	Ганчарэвіч Віктар Георгіевіч
Гарбачову Ганну Сяргееўну|	Гарбачова Ганна Сяргееўна
Гаркавага Максіма Вячаслававіча|	Гаркавы Максім Вячаслававіч
Гецікава Сяргея Мікалаевіча|	Гецікаў Сяргей Мікалаевіч
Грыко Юрыя Мікалаевіча|	Грыко Юрый Мікалаевіч
Грыневіча Юрыя Анатольевіча|	Грыневіч Юрый Анатольевіч
Гузава Віталія Уладзіміравіча|	Гузаў Віталій Уладзіміравіч
Гузіча Алега Аляксандравіча|	Гузіч Алег Аляксандравіч
Гунько Віталія Мікалаевіча|	Гунько Віталій Мікалаевіч
Гурэвіча Рыгора Эдуардавіча|	Гурэвіч Рыгор Эдуардавіч
Гусакова Віктара Пятровіча|	Гусакоў Віктар Пятровіч
Дадылу Вадзіма Валер’евіча|	Дадыла Вадзім Валер’евіч
Дарэўскага Ігара Часлававіча|	Дарэўскі Ігар Часлававіч
Джыгу Анатолія Іванавіча|	Джыга Анатолій Іванавіч
Дзейчыка Сяргея Паўлавіча|	Дзейчык Сяргей Паўлавіч
Дзікарава Ігара Уладзіміравіча|	Дзікараў Ігар Уладзіміравіч
Дзямешчанка Вольгу Уладзіміраўну|	Дзямешчанка Вольга Уладзіміраўна
Драбкова Андрэя Алегавіча|	Драбкоў Андрэй Алегавіч
Дразда Андрэя Уладзіміравіча|	Дразд Андрэй Уладзіміравіч
Дудаладаву Наталлю Сцяпанаўну|	Дудаладава Наталля Сцяпанаўна
Дурэйку Юрыя Уладзіміравіча|	Дурэйка Юрый Уладзіміравіч
Дыро Юрыя Вацлававіча|	Дыро Юрый Вацлававіч
Ерашова Сяргея Уладзіміравіча|	Ерашоў Сяргей Уладзіміравіч
Жданко Міхаіла Міхайлавіча|	Жданко Міхаіл Міхайлавіч
Жураўлёва Івана Уладзіміравіча|	Жураўлёў Іван Уладзіміравіч
Жынко Анатолія Яўгеньевіча|	Жынко Анатолій Яўгеньевіч
Забаўку Івана Васільевіча|	Забаўка Іван Васільевіч
Завадскага Анатолія Дзмітрыевіча|	Завадскі Анатолій Дзмітрыевіч
Загароўскага Ігара Канстанцінавіча|	Загароўскі Ігар Канстанцінавіч
Загорскага Сцяпана Яўгеньевіча|	Загорскі Сцяпан Яўгеньевіч
Зайца Андрэя Міхайлавіча|	Зайц Андрэй Міхайлавіч
Зайцава Віталія Віктаравіча|	Зайцаў Віталій Віктаравіч
Змітровіча Міхаіла Васільевіча|	Змітровіч Міхаіл Васільевіч
Зязюліна Івана Фёдаравіча|	Зязюлін Іван Фёдаравіч
Іванова Максіма Рыгоравіча|	Іваноў Максім Рыгоравіч
Івановіча Мікалая Мікалаевіча|	Івановіч Мікалай Мікалаевіч
Ісаенку Дзмітрыя Анатольевіча|	Ісаенка Дзмітрый Анатольевіч
Кабрынца Аляксандра Аляксандравіча|	Кабрынец Аляксандр Аляксандравіч
Кавалеўскага Сяргея Іванавіча|	Кавалеўскі Сяргей Іванавіч
Кавалёву Наталлю Міхайлаўну|	Кавалёва Наталля Міхайлаўна
Кадлубовіча Віталія Леанідавіча|	Кадлубовіч Віталій Леанідавіч
Казакову Ірыну Уладзіміраўну|	Казакова Ірына Уладзіміраўна
Казачэнку Дзмітрыя Уладзіміравіча|	Казачэнка Дзмітрый Уладзіміравіч
Казлова Віталія Анатольевіча|	Казлоў Віталій Анатольевіч
Каліна Валерыя Васільевіча|	Калін Валерый Васільевіч
Каляду Дзяніса Васільевіча|	Каляда Дзяніс Васільевіч
Канашэвіча Сяргея Яўгеньевіча|	Канашэвіч Сяргей Яўгеньевіч
Канстанцінава Сяргея Сяргеевіча|	Канстанцінаў Сяргей Сяргеевіч
Капралава Мікалая Аляксандравіча|	Капралаў Мікалай Аляксандравіч
Кароткую Ірыну Пятроўну|	Кароткая Ірына Пятроўна
Карпука Валерыя Васільевіча|	Карпук Валерый Васільевіч
Касцяневіча Аляксандра Анатольевіча|	Касцяневіч Аляксандр Анатольевіч
Каўпак Юлію Чэславаўну|	Каўпак Юлія Чэславаўна
Каўтунова Ягора Васільевіча|	Каўтуноў Ягор Васільевіч
Качэргіна Аляксандра Аляксандравіча|	Качэргін Аляксандр Аляксандравіч
Кашко Сяргея Міхайлавіча|	Кашко Сяргей Міхайлавіч
Кеза Алега Міхайлавіча|	Кез Алег Міхайлавіч
Кірылава Дзмітрыя Дзмітрыевіча|	Кірылаў Дзмітрый Дзмітрыевіч
Кірылава Міхаіла Яўгеньевіча|	Кірылаў Міхаіл Яўгеньевіч
Клопава Андрэя Іванавіча|	Клопаў Андрэй Іванавіч
Клышко Васіля Андрэевіча|	Клышко Васіль Андрэевіч
Коваля Сяргея Пятровіча|	Коваль Сяргей Пятровіч
Козела Мікалая Мікалаевіча|	Козел Мікалай Мікалаевіч
Кракасевіча Ігара Іванавіча|	Кракасевіч Ігар Іванавіч
Краўца Анатолія Міхайлавіча|	Кравец Анатолій Міхайлавіч
Крола Міхаіла Максавіча|	Крол Міхаіл Максавіч
Крукава Уладзіміра Мікалаевіча|	Крукаў Уладзімір Мікалаевіч
Кудэлку Юрыя Аляксандравіча|	Кудэлка Юрый Аляксандравіч
Кузняцова Юрыя Сяргеевіча|	Кузняцоў Юрый Сяргеевіч
Кулагіна Паўла Іванавіча|	Кулагін Павел Іванавіч
Куляя Анатолія Віктаравіча|	Куляь Анатолій Віктаравіч
Купцова Юрыя Мікалаевіча|	Купцоў Юрый Мікалаевіч
Курко Мікалая Аляксандравіча|	Курко Мікалай Аляксандравіч
Курпіка Сяргея Аляксеевіча|	Курпік Сяргей Аляксеевіч
Кухаронка Сяргея Генадзьевіча|	Кухаронак Сяргей Генадзьевіч
Кушнарова Дзмітрыя Мікалаевіча|	Кушнароў Дзмітрый Мікалаевіч
Кяўру Міхаіла Вацлававіча|	Кяўра Міхаіл Вацлававіч
Лазарыашвілі Іосіфа Валяр’янавіча|	Лазарыашвілі Іосіф Валяр’янавіч
Лапаценку Алега Аляксандравіча|	Лапаценка Алег Аляксандравіч
Лапуцьку Анатоля Міхайлавіча|	Лапуцька Анатоль Міхайлавіч
Ліпляніна Мікалая Мікалаевіча|	Ліплянін Мікалай Мікалаевіч
Лісаўца Віктара Часлававіча|	Лісавец Віктар Часлававіч
Літвінава Паўла Мікалаевіча|	Літвінаў Павел Мікалаевіч
Ліхоту Віктара Яўгеньевіча|	Ліхота Віктар Яўгеньевіч
Лужанскага Дзмітрыя Анатольевіча|	Лужанскі Дзмітрый Анатольевіч
Лук’яненку Мікалая Анатольевіча|	Лук’яненка Мікалай Анатольевіч
Лук’яніцу Сяргея Аляксандравіча|	Лук’яніца Сяргей Аляксандравіч
Лунева Уладзіміра Васільевіча|	Лунеў Уладзімір Васільевіч
Лутовіча Паўла Валер’евіча|	Лутовіч Павел Валер’евіч
Макаранку Данііла Міхайлавіча|	Макаранка Данііл Міхайлавіч
Малашэвіча Уладзіміра Вячаслававіча|	Малашэвіч Уладзімір Вячаслававіч
Мамоньку Валерыя Анатольевіча|	Мамонька Валерый Анатольевіч
Манькова Міхаіла Васільевіча|	Манькоў Міхаіл Васільевіч
Мароза Паўла Вацлававіча|	Мароз Павел Вацлававіч
Мархотка Святлану Іванаўну|	Мархотка Святлана Іванаўна
Маслоўскага Ігара Генадзьевіча|	Маслоўскі Ігар Генадзьевіч
Масцепанава Васілія Васільевіча|	Масцепанаў Васілій Васільевіч
Мацака Аляксея Паўлавіча|	Мацак Аляксей Паўлавіч
Мельнікава Сяргея Рыгоравіча|	Мельнікаў Сяргей Рыгоравіч
Мелянца Дзмітрыя Вітальевіча|	Мелянец Дзмітрый Вітальевіч
Мінчукову Валянціну Сямёнаўну|	Мінчукова Валянціна Сямёнаўна
Мірановіча Андрэя Уладзіміравіча|	Мірановіч Андрэй Уладзіміравіч
Міранюка Міхаіла Канстанцінавіча|	Міранюк Міхаіл Канстанцінавіч
Міронава Дзмітрыя Леанідавіча|	Міронаў Дзмітрый Леанідавіч
Моханя Аляксандра Фёдаравіча|	Мохань Аляксандр Фёдаравіч
Мураўёва Алега Іванавіча|	Мураўёў Алег Іванавіч
Мысліўца Уладзіміра Станіслававіча|	Мыслівец Уладзімір Станіслававіч
Нагорнага Сяргея Андрэевіча|	Нагорны Сяргей Андрэевіч
Надзейку Андрэя Тадэвушавіча|	Надзейка Андрэй Тадэвушавіч
Науменку Юрыя Іванавіча|	Науменка Юрый Іванавіч
Немагая Міхаіла Міхайлавіча|	Немагай Міхаіл Міхайлавіч
Нікіценка Наталлю Георгіеўну|	Нікіценка Наталля Георгіеўна
Носаву Алену Леанідаўну|	Носава Алена Леанідаўна
Падцяроб Вольгу Віктараўну|	Падцяроб Вольга Віктараўна
Палідаўца Аляксандра Валерыевіча|	Палідавец Аляксандр Валерыевіч
Панцелеймона Івана Іванавіча|	Панцелеймон Іван Іванавіч
Патарочу Максіма Уладзіміравіча|	Патароча Максім Уладзіміравіч
Патрываева Дзмітрыя Яўгенавіча|	Патрываеў Дзмітрый Яўгенавіч
Паўлава Эдуарда Васільевіча|	Паўлаў Эдуард Васільевіч
Паўлюковіча Сяргея Мікалаевіча|	Паўлюковіч Сяргей Мікалаевіч
Пачкоўскага Пятра Антонавіча|	Пачкоўскі Пётр Антонавіч
Пашкевіча Віктара Пятровіча|	Пашкевіч Віктар Пятровіч
Пехцерава Андрэя Іванавіча|	Пехцераў Андрэй Іванавіч
Пракоф’ева Віктара Уладзіміравіча|	Пракоф’еў Віктар Уладзіміравіч
Протаса Уладзіміра Пятровіча|	Протас Уладзімір Пятровіч
Пручкоўскага Віталія Алегавіча|	Пручкоўскі Віталій Алегавіч
Прыкоту Канстанціна Андрэевіча|	Прыкота Канстанцін Андрэевіч
Прыстромава Віталія Валер’евіча|	Прыстромаў Віталій Валер’евіч
Пуцык Алену Уладзіміраўну|	Пуцык Алена Уладзіміраўна
Пучкова Андрэя Аркадзьевіча|	Пучкоў Андрэй Аркадзьевіч
Пятровіча Юрыя Аркадзьевіча|	Пятровіч Юрый Аркадзьевіч
Рагіню Валерыя Паўлавіча|	Рагіня Валерый Паўлавіч
Радзюка Віталія Аляксандравіча|	Радзюк Віталій Аляксандравіч
Разумца Аляксандра Аляксандравіча|	Разумц Аляксандр Аляксандравіч
Райценку Вячаслава Сяргеевіча|	Райценка Вячаслаў Сяргеевіч
Рамановіча Аляксандра Аляксандравіча|	Рамановіч Аляксандр Аляксандравіч
Раманюка Уладзіміра Іванавіча|	Раманюк Уладзімір Іванавіч
Родзіна Сяргея Юр’евіча|	Родзін Сяргей Юр’евіч
Рынцэвіча Станіслава Генадзьевіча|	Рынцэвіч Станіслаў Генадзьевіч
Рэуцкага Сяргея Ігаравіча|	Рэуцкі Сяргей Ігаравіч
Савельеву Валянціну Міхайлаўну|	Савельева Валянціна Міхайлаўна
Савінава Сяргея Вячаслававіча|	Савінаў Сяргей Вячаслававіч
Садоўскага Генадзя Іванавіча|	Садоўскі Генадзь Іванавіч
Салтанаву Інесу Уладзіміраўну|	Салтанава Інеса Уладзіміраўна
Салянко Дзмітрыя Андрэевіча|	Салянко Дзмітрый Андрэевіч
Сапешку Юрыя Анатольевіча|	Сапешка Юрый Анатольевіч
Сапраненка Ірыну Паўлаўну|	Сапраненка Ірына Паўлаўна
Сафановіча Анатолія Міхайлавіча|	Сафановіч Анатолій Міхайлавіч
Свянтоху Валянціна Іванавіча|	Свянтоха Валянцін Іванавіч
Селеха Паўла Леанідавіча|	Селех Павел Леанідавіч
Селязнёва Дзмітрыя Аляксандравіча|	Селязнёў Дзмітрый Аляксандравіч
Семерыкова Сяргея Рыгоравіча|	Семерыкоў Сяргей Рыгоравіч
Семяніду Рамана Леанідавіча|	Семяніда Раман Леанідавіч
Серахана Віталія Вацлававіча|	Серахан Віталій Вацлававіч
Сідарука Уладзіміра Цімафеевіча|	Сідарук Уладзімір Цімафеевіч
Сілкова Пятра Лявонавіча|	Сілкоў Пётр Лявонавіч
Скіпара Мікалая Міхайлавіча|	Скіпар Мікалай Міхайлавіч
Скуднага Аляксандра Леанідавіча|	Скудны Аляксандр Леанідавіч
Слабыню Леаніда Іванавіча|	Слабыня Леанід Іванавіч
Слаўнікава Яўгенія Васільевіча|	Слаўнікаў Яўгеній Васільевіч
Смаршчка Мікалая Аляксеевіча|	Смаршчк Мікалай Аляксеевіч
Сніткова Ігара Усеваладавіча|	Сніткоў Ігар Усеваладавіч
Спірыду Аляксандра Іванавіча|	Спірыда Аляксандр Іванавіч
Станкевіч Галіну Мікалаеўну|	Станкевіч Галіна Мікалаеўна
Старавойтава Канстанціна Сяргеевіча|	Старавойтаў Канстанцін Сяргеевіч
Сухараву Алену Аляксандраўну|	Сухарава Алена Аляксандраўна
Сушчэвіча Віктара Міхайлавіча|	Сушчэвіч Віктар Міхайлавіч
Сцежко Ірыну Міхайлаўну|	Сцежко Ірына Міхайлаўна
Сцефановіч Алу Сцяпанаўну|	Сцефановіч Ала Сцяпанаўна
Сцяшковіча Аляксандра Анатольевіча|	Сцяшковіч Аляксандр Анатольевіч
Сысоева Аляксея Сяргеевіча|	Сысоеў Аляксей Сяргеевіч
Сычова Міхаіла Аляксандравіча|	Сычоў Міхаіл Аляксандравіч
Тамашэвіча Віталія Фаміча|	Тамашэвіч Віталій Фаміч
Тамашэўскага Віталія Вячэслававіча|	Тамашэўскі Віталій Вячэслававіч
Тамілу Дзмітрыя Леанідавіча|	Таміла Дзмітрый Леанідавіч
Тарасёнка Аляксандра Мікалаевіча|	Тарасёнак Аляксандр Мікалаевіч
Татарэвіча Міхаіла Іванавіча|	Татарэвіч Міхаіл Іванавіч
Ткачова Аляксандра Мікалаевіча|	Ткачоў Аляксандр Мікалаевіч
Траццякова Мікалая Мікалаевіча|	Траццякоў Мікалай Мікалаевіч
Траянава Аляксандра Валер’евіча|	Траянаў Аляксандр Валер’евіч
Трутко Юрыя Ігаравіча|	Трутко Юрый Ігаравіч
Тупеку Сяргея Станіслававіча|	Тупека Сяргей Станіслававіч
Турашава Віталія Георгіевіча|	Турашаў Віталій Георгіевіч
Уласевіча Валерыя Часлававіча|	Уласевіч Валерый Часлававіч
Улейку Сяргея Леанідавіча|	Улейка Сяргей Леанідавіч
Федарца Сяргея Васільевіча|	Федарц Сяргей Васільевіч
Фралова Аляксея Сяргеевіча|	Фралоў Аляксей Сяргеевіч
Хадановіча Уладзіміра Віктаравіча|	Хадановіч Уладзімір Віктаравіч
Харкевіча Валерыя Рыгоравіча|	Харкевіч Валерый Рыгоравіч
Харужага Уладзіміра Мікалаевіча|	Харужы Уладзімір Мікалаевіч
Харушэўскага Яўгенія Эдуардавіча|	Харушэўскі Яўгеній Эдуардавіч
Харытоненку Віктара Віктаравіча|	Харытоненка Віктар Віктаравіч
Цімошчанку Уладзіміра Мікалаевіча|	Цімошчанка Уладзімір Мікалаевіч
Цумарава Алега Міхайлавіча|	Цумараў Алег Міхайлавіч
Цыкунова Яўгена Міхайлавіча|	Цыкуноў Яўген Міхайлавіч
Цыплакова Мікалая Аляксеевіча|	Цыплакоў Мікалай Аляксеевіч
Цэлабёнка Сяргея Міхайлавіча|	Цэлабёнак Сяргей Міхайлавіч
Чаплінскага Алега Іванавіча|	Чаплінскі Алег Іванавіч
Чаплінскага Вадзіма Эдуардавіча|	Чаплінскі Вадзім Эдуардавіч
Чарнякова Кірыла Віктаравіча|	Чарнякоў Кірыл Віктаравіч
Чэрнушэвіча Віктара Іванавіча|	Чэрнушэвіч Віктар Іванавіч
Шаблінскага Уладзіміра Уладзіміравіча|	Шаблінскі Уладзімір Уладзіміравіч
Шалакова Уладзіміра Аляксеевіча|	Шалакоў Уладзімір Аляксеевіч
Шарынскага Эдуарда Ігнацьевіча|	Шарынскі Эдуард Ігнацьевіч
Шарычкава Сяргея Уладзіміравіча|	Шарычкаў Сяргей Уладзіміравіч
Шкулькова Дзмітрыя Аляксеевіча|	Шкулькоў Дзмітрый Аляксеевіч
Шпаковіча Валерыя Леанідавіча|	Шпаковіч Валерый Леанідавіч
Штуціна Ігара Яўгеньевіча|	Штуцін Ігар Яўгеньевіч
Шуміна Дзяніса Генадзьевіча|	Шумін Дзяніс Генадзьевіч
Шчадрынскага Віталя Леанідавіча|	Шчадрынскі Віталь Леанідавіч
Шыкаўку Аляксандра Іванавіча|	Шыкаўка Аляксандр Іванавіч
Шыліна Андрэя Мікалаевіча|	Шылін Андрэй Мікалаевіч
Шышко Уладзіміра Вітальевіча|	Шышко Уладзімір Вітальевіч
Шэлегаву Кацярыну Дзмітрыеўну|	Шэлегава Кацярына Дзмітрыеўна
Юрасёва Андрэя Васільевіча|	Юрасёў Андрэй Васільевіч
Юрэвіча Віталія Лявонавіча|	Юрэвіч Віталій Лявонавіч
Якаўлева Сяргея Пятровіча|	Якаўлеў Сяргей Пятровіч
Якаўца Уладзіміра Уладзіміравіча|	Якавец Уладзімір Уладзіміравіч
Януш Ларысу Віктараўну|	Януш Ларыса Віктараўна
Янчанку Аляксея Уладзіміравіча|	Янчанка Аляксей Уладзіміравіч
Яроменку Аляксея Генадзьевіча|	Яроменка Аляксей Генадзьевіч
Яхнаўца Дзмітрыя Рыгоравіча|	Яхнавец Дзмітрый Рыгоравіч
Яшчанку Сяргея Іванавіча|	Яшчанка Сяргей Іванавіч
Жураўлёва Аляксандра Юр’евіча|	Жураўлёў Аляксандр Юр’евіч
Ніжэвіч Людмілу Іванаўну|	Ніжэвіч Людміла Іванаўна
Жука Аляксандра Іванавіча|	Жук Аляксандр Іванавіч
Карачэўскага Уладзіміра Міхайлавіча|	Карачэўскі Уладзімір Міхайлавіч
Кірыенку Валерыя Міхайлавіча|	Кірыенка Валерый Міхайлавіч
Карнацэвіча Івана Іванавіча|	Карнацэвіч Іван Іванавіч
Мураўскага Генрыка Раманавіча|	Мураўскі Генрык Раманавіч
Бобырава Аляксандра Пятровіча|	Бобыраў Аляксандр Пятровіч
Вайтуховіча Мікалая Рыгоравіча|	Вайтуховіч Мікалай Рыгоравіч
Власавец Таццяну Іванаўну|	Власавец Таццяна Іванаўна
Кавалеўскую Наталлю Васільеўну|	Кавалеўская Наталля Васільеўна
Каранца Івана Мікалаевіча|	Каранец Іван Мікалаевіч
Рудзянкову Галіну Іванаўну|	Рудзянкова Галіна Іванаўна
Голуба Аляксандра Васільевіча|	Голуб Аляксандр Васільевіч
Ефіменку Міхаіла Кузьміча|	Ефіменка Міхаіл Кузьміч
Нікіценку Яўгена Уладзіміравіча|	Нікіценка Яўген Уладзіміравіч
Круглея Ігара Аляксандравіча|	Круглей Ігар Аляксандравіч
Беларусца Віктара Мікалаевіча|	Беларусц Віктар Мікалаевіч
Вільчэўскую Ганну Іванаўну|	Вільчэўская Ганна Іванаўна
Зуева Мікалая Іванавіча|	Зуеў Мікалай Іванавіч
Каско Ігара Барысавіча|	Каско Ігар Барысавіч
Саўко Яўгенія Вацлававіча|	Саўко Яўгеній Вацлававіч
Філановіча Расціслава Міхайлавіча|	Філановіч Расціслаў Міхайлавіч
Януковіч Таццяну Фёдараўну|	Януковіч Таццяна Фёдараўна
Вялічку Валянціна Уладзіміравіча|	Вялічка Валянцін Уладзіміравіч
Кавалёву-Савацееву Наталію Аляксееўну|	Кавалёву-Савацеева Наталія Аляксееўна
Крывашэева Юрыя Васільевіча|	Крывашэеў Юрый Васільевіч
Сцепука Анатоля Якаўлевіча|	Сцепук Анатоль Якаўлевіч
Грушкевіча Сяргея Антонавіча|	Грушкевіч Сяргей Антонавіч
Корзуна Аляксандра Яўгеньевіча|	Корзун Аляксандр Яўгеньевіч
Лахая Сяргея Іванавіча|	Лахай Сяргей Іванавіч
Пучкоўскага Андрэя Антонавіча|	Пучкоўскі Андрэй Антонавіч
Ткачэнку Сяргея Аляксеевіча|	Ткачэнка Сяргей Аляксеевіч
Цімафеева Андрэя Аляксандравіча|	Цімафееў Андрэй Аляксандравіч
Чэрніка Ігара Уладзіміравіча|	Чэрнік Ігар Уладзіміравіч
Бабко Рыгора Мікалаевіча|	Бабко Рыгор Мікалаевіч
Башкевіча Сяргея Сяргеевіча|	Башкевіч Сяргей Сяргеевіч
Безабразава Аляксандра Валер’евіча|	Безабразаў Аляксандр Валер’евіч
Белюся Уладзіміра Уладзіміравіча|	Белюсь Уладзімір Уладзіміравіч
Білібуху Аляксандра Якаўлевіча|	Білібуха Аляксандр Якаўлевіч
Боева Вадзіма Валянцінавіча|	Боеў Вадзім Валянцінавіч
Васільцова Аляксандра Ігаравіча|	Васільцоў Аляксандр Ігаравіч
Васілюка Аляксандра Уладзіміравіча|	Васілюк Аляксандр Уладзіміравіч
Васілюшкава Юрыя Іванавіча|	Васілюшкаў Юрый Іванавіч
Вашынку Аляксандра Генадзьевіча|	Вашынка Аляксандр Генадзьевіч
Галубых Яўгенія Мікалаевіча|	Галубых Яўгеній Мікалаевіч
Гладкага Сяргея Вячаслававіча|	Гладкі Сяргей Вячаслававіч
Дзіканёва Андрэя Уладзіміравіча|	Дзіканёў Андрэй Уладзіміравіч
Дзюжава Генадзія Юр’евіча|	Дзюжаў Генадзій Юр’евіч
Дыско Генадзія Іосіфавіча|	Дыско Генадзій Іосіфавіч
Жураўлёва Генадзія Уладзіміравіча|	Жураўлёў Генадзій Уладзіміравіч
Жушму Вадзіма Вітальевіча|	Жушма Вадзім Вітальевіч
Казака Аляксандра Віктаравіча|	Казак Аляксандр Віктаравіч
Казакову Алену Уладзіміраўну|	Казакова Алена Уладзіміраўна
Котава Аляксандра Аляксандравіча|	Котаў Аляксандр Аляксандравіч
Куцэвіча Уладзіміра Уладзіміравіча|	Куцэвіч Уладзімір Уладзіміравіч
Лапцінскага Юрыя Уладзіміравіча|	Лапцінскі Юрый Уладзіміравіч
Лаўрухіна Алега Уладзіміравіча|	Лаўрухін Алег Уладзіміравіч
Леўшука Міхаіла Вікенцьевіча|	Леўшук Міхаіл Вікенцьевіч
Макарэвіча Сяргея Васільевіча|	Макарэвіч Сяргей Васільевіч
Міцькаўца Мікалая Мікалаевіча|	Міцькавец Мікалай Мікалаевіч
Муранцова Вячаслава Віктаравіча|	Муранцоў Вячаслаў Віктаравіч
Нічыпаровіча Алега Станіслававіча|	Нічыпаровіч Алег Станіслававіч
Пархоменку Аляксандра Аляксандравіча|	Пархоменка Аляксандр Аляксандравіч
Працкевіча Міхаіла Яўгенавіча|	Працкевіч Міхаіл Яўгенавіч
Пухнянкова Дзмітрыя Міхайлавіча|	Пухнянкоў Дзмітрый Міхайлавіч
Пыж Жану Пятроўну|	Пыж Жана Пятроўна
Рагізнага Уладзіміра Мікалаевіча|	Рагізны Уладзімір Мікалаевіч
Ракевіча Аляксандра Іванавіча|	Ракевіч Аляксандр Іванавіч
Свірыдовіча Анатолія Міхайлавіча|	Свірыдовіч Анатолій Міхайлавіч
Сеўрука Эдуарда Францавіча|	Сеўрук Эдуард Францавіч
Сірэнку Сяргея Алегавіча|	Сірэнка Сяргей Алегавіч
Сянько Віталія Францавіча|	Сянько Віталій Францавіч
Фалецкага Анатолія Аляксеевіча|	Фалецкі Анатолій Аляксеевіч
Хмарука Сяргея Канстанцінавіча|	Хмарук Сяргей Канстанцінавіч
Ціцянкова Ігара Валер’евіча|	Ціцянкоў Ігар Валер’евіч
Цягліка Грыгорыя Пятровіча|	Цяглік Грыгорый Пятровіч
Чарапка Вячаслава Іванавіча|	Чарапк Вячаслаў Іванавіч
Чыжова Сяргея Уладзіміравіча|	Чыжоў Сяргей Уладзіміравіч
Шаўкунова Сяргея Мікалаевіча|	Шаўкуноў Сяргей Мікалаевіч
Шокава Аляксандра Уладзіміравіча|	Шокаў Аляксандр Уладзіміравіч
Шырко Юрыя Генадзьевіча|	Шырко Юрый Генадзьевіч
Юнца Аляксандра Іосіфавіча|	Юнец Аляксандр Іосіфавіч
Яхімчыка Анатолія Іосіфавіча|	Яхімчык Анатолій Іосіфавіч
Ажгірэя Алега Анатольевіча|	Ажгірэй Алег Анатольевіч
Азарчыка Аляксея Васільевіча|	Азарчык Аляксей Васільевіч
Алексяевіча Сяргея Віктаравіча|	Алексяевіч Сяргей Віктаравіч
Анашачкіна Дзмітрыя Анатольевіча|	Анашачкін Дзмітрый Анатольевіч
Андрэева Мікалая Аляксандравіча|	Андрэеў Мікалай Аляксандравіч
Анішчука Рыгора Аляксандравіча|	Анішчук Рыгор Аляксандравіч
Аўсюка Анатолія Тадэвушавіча|	Аўсюк Анатолій Тадэвушавіч
Бабуліна Аляксандра Віктаравіча|	Бабулін Аляксандр Віктаравіч
Байдакова Максіма Мікалаевіча|	Байдакоў Максім Мікалаевіч
Батухціна Андрэя Вячаслававіча|	Батухцін Андрэй Вячаслававіч
Башкевіча Яўгенія Мікалаевіча|	Башкевіч Яўгеній Мікалаевіч
Белякова Вячаслава Мікалаевіча|	Белякоў Вячаслаў Мікалаевіч
Бірука Андрэя Іванавіча|	Бірук Андрэй Іванавіч
Борыса Сяргея Барысавіча|	Борыс Сяргей Барысавіч
Булыню Васілія Васільевіча|	Булыня Васілій Васільевіч
Бурак Алу Чаславаўну|	Бурак Ала Чаславаўна
Буяка Генадзія Аляксеевіча|	Буяк Генадзій Аляксеевіч
Быконю Дзмітрыя Леанідавіча|	Быконя Дзмітрый Леанідавіч
Бялевіча Уладзіміра Федаравіча|	Бялевіч Уладзімір Федаравіч
Валеўку Леаніда Яўгеньевіча|	Валеўка Леанід Яўгеньевіч
Варфаламеева Руслана Уладзіміравіча|	Варфаламееў Руслан Уладзіміравіч
Васенду Дзмітрыя Аляксандравіча|	Васенда Дзмітрый Аляксандравіч
Васькоўскага Пятра Пятровіча|	Васькоўскі Пётр Пятровіч
Вялікасвята Уладзіміра Пятровіча|	Вялікасвят Уладзімір Пятровіч
Гайдукова Дзмітрыя Сяргеевіча|	Гайдукоў Дзмітрый Сяргеевіч
Гарбачэўскую Вольгу Мікалаеўну|	Гарбачэўская Вольга Мікалаеўна
Гарноўскага Аляксандра Мікалаевіча|	Гарноўскі Аляксандр Мікалаевіч
Глоба Вікторыю Аляксандраўну|	Глоба Вікторыя Аляксандраўна
Грака Міхаіла Юр’евіча|	Грак Міхаіл Юр’евіч
Грыневіч Людмілу Эдуардаўну|	Грыневіч Людміла Эдуардаўна
Грышкаўца Сяргея Аляксеевіча|	Грышкавец Сяргей Аляксеевіч
Данілковіча Уладзіміра Іосіфавіча|	Данілковіч Уладзімір Іосіфавіч
Данількевіча Андрэя Іванавіча|	Данількевіч Андрэй Іванавіч
Даўгалюка Уладзіміра Іосіфавіча|	Даўгалюк Уладзімір Іосіфавіч
Дзьячкова Сяргея Юр’евіча|	Дзьячкоў Сяргей Юр’евіч
Дразда Дзмітрыя Мікалаевіча|	Дразд Дзмітрый Мікалаевіч
Емельяновіча Васілія Канстанцінавіча|	Емельяновіч Васілій Канстанцінавіч
Емяльянава Андрэя Леанідавіча|	Емяльянаў Андрэй Леанідавіч
Епанешнікава Дзяніса Генадзіевіча|	Епанешнікаў Дзяніс Генадзіевіч
Ермалаева Дзмітрыя Віктаравіча|	Ермалаеў Дзмітрый Віктаравіч
Жарнасека Віталія Мікалаевіча|	Жарнасек Віталій Мікалаевіч
Жукоўскага Сяргея Міхайлавіча|	Жукоўскі Сяргей Міхайлавіч
Жутчанку Дзмітрыя Леанідавіча|	Жутчанка Дзмітрый Леанідавіч
Жывульку Дзмітрыя Іванавіча|	Жывулька Дзмітрый Іванавіч
Жылевіча Андрэя Тадэвушавіча|	Жылевіч Андрэй Тадэвушавіч
Зварыку Віталія Аляксандравіча|	Зварыка Віталій Аляксандравіч
Зуя Міхаіла Іванавіча|	Зуй Міхаіл Іванавіч
Іванкіна Аляксея Мікалаевіча|	Іванкін Аляксей Мікалаевіч
Івашкевіча Аляксея Аркадзьевіча|	Івашкевіч Аляксей Аркадзьевіч
Ільёва Ігара Георгіевіча|	Ільёў Ігар Георгіевіч
Ільніцкага Вадзіма Канстанцінавіча|	Ільніцкі Вадзім Канстанцінавіч
Калача Дзмітрыя Яўгенавіча|	Калач Дзмітрый Яўгенавіч
Камарчук Алену Юр’еўну|	Камарчук Алена Юр’еўна
Канашэнку Андрэя Віктаравіча|	Канашэнка Андрэй Віктаравіч
Кандрашова Аляксея Віктаравіча|	Кандрашоў Аляксей Віктаравіч
Карасева Аляксея Генадзьевіча|	Карасеў Аляксей Генадзьевіч
Карповіча Андрэя Валер’евіча|	Карповіч Андрэй Валер’евіч
Качаноўскага Андрэя Юр’евіча|	Качаноўскі Андрэй Юр’евіч
Кірылюка Аляксандра Мікалаевіча|	Кірылюк Аляксандр Мікалаевіч
Кліменку Сяргея Аляксеевіча|	Кліменка Сяргей Аляксеевіч
Князюка Аляксея Васільевіча|	Князюк Аляксей Васільевіч
Кончыца Андрэя Аляксандравіча|	Кончыц Андрэй Аляксандравіч
Косцікава Дзмітрыя Яўгеньевіча|	Косцікаў Дзмітрый Яўгеньевіч
Крачко Анатолія Андрэевіча|	Крачко Анатолій Андрэевіч
Крупеньку Аляксея Уладзіміравіча|	Крупенька Аляксей Уладзіміравіч
Крыжэвіча Уладзіміра Мікалаевіча|	Крыжэвіч Уладзімір Мікалаевіч
Крыўца Алега Анатольевіча|	Крывец Алег Анатольевіч
Кузняцова Сяргея Аляксандравіча|	Кузняцоў Сяргей Аляксандравіч
Кузняцова Сяргея Мікалаевіча|	Кузняцоў Сяргей Мікалаевіч
Кутынку Цімафея Міхайлавіча|	Кутынка Цімафей Міхайлавіч
Кучынскага Вадзіма Леанідавіча|	Кучынскі Вадзім Леанідавіч
Ладзік Ірыну Паўлаўну|	Ладзік Ірына Паўлаўна
Лайкову Ларысу Валер’еўну|	Лайкова Ларыса Валер’еўна
Ланчука Андрэя Васільевіча|	Ланчук Андрэй Васільевіч
Ластоўскую Лідзію Мікалаеўну|	Ластоўская Лідзія Мікалаеўна
Ліепу Віталя Эдмундавіча|	Ліепа Віталь Эдмундавіч
Ліпскага Анатолія Станіслававіча|	Ліпскі Анатолій Станіслававіч
Лісіцкага Сяргея Георгіевіча|	Лісіцкі Сяргей Георгіевіч
Літвіненку Аляксандра Мікалаевіча|	Літвіненка Аляксандр Мікалаевіч
Ліхарада Ігара Уладзіміравіча|	Ліхарад Ігар Уладзіміравіч
Лукашэвіча Аляксандра Міхайлавіча|	Лукашэвіч Аляксандр Міхайлавіч
Лысяка Андрэя Юр’евіча|	Лысяк Андрэй Юр’евіч
Ляўкоўскага Аляксандра Францавіча|	Ляўкоўскі Аляксандр Францавіч
Макарава Сяргея Фёдаравіча|	Макараў Сяргей Фёдаравіч
Маляра Уладзіслава Уладзіміравіча|	Маляр Уладзіслаў Уладзіміравіч
Маргулевіча Сяргея Віктаравіча|	Маргулевіч Сяргей Віктаравіч
Мармыша Уладзіміра Уладзіміравіча|	Мармыш Уладзімір Уладзіміравіч
Марцінкевіча Аляксандра Дзмітрыевіча|	Марцінкевіч Аляксандр Дзмітрыевіч
Матвееву Наталлю Юр’еўну|	Матвеева Наталля Юр’еўна
Мілевіча Дзмітрыя Вітальевіча|	Мілевіч Дзмітрый Вітальевіч
Мычко Уладзіміра Мікалаевіча|	Мычко Уладзімір Мікалаевіч
Мядзюху Аляксандра Пятровіча|	Мядзюха Аляксандр Пятровіч
Навіцкага Аляксандра Фёдаравіча|	Навіцкі Аляксандр Фёдаравіч
Навіцкага Дзяніса Анатольевіча|	Навіцкі Дзяніс Анатольевіч
Новіка Дзмітрыя Міхайлавіча|	Новік Дзмітрый Міхайлавіч
Осіпава Уладзіміра Яўгеньевіча|	Осіпаў Уладзімір Яўгеньевіч
Пагосава Рамана Георгіевіча|	Пагосаў Раман Георгіевіч
Панцялея Дзмітрыя Віктаравіча|	Панцялей Дзмітрый Віктаравіч
Паршука Вячаслава Аляксандравіча|	Паршук Вячаслаў Аляксандравіч
Пастарнака Уладзіміра Іванавіча|	Пастарнак Уладзімір Іванавіч
Патоцкага Юрыя Рыгоравіча|	Патоцкі Юрый Рыгоравіч
Паўтарана Аляксандра Аляксеевіча|	Паўтаран Аляксандр Аляксеевіч
Пешчура Андрэя Уладзіміравіча|	Пешчур Андрэй Уладзіміравіч
Праневіча Віктара Юр’евіча|	Праневіч Віктар Юр’евіч
Прылуцкага Эдуарда Лявонцьевіча|	Прылуцкі Эдуард Лявонцьевіч
Пятровіча Аляксея Мікалаевіча|	Пятровіч Аляксей Мікалаевіч
Ракава Аляксея Эдуардавіча|	Ракаў Аляксей Эдуардавіч
Ракаўца Дзмітрыя Мікалаевіча|	Ракавец Дзмітрый Мікалаевіч
Ракевіча Мікалая Мікалаевіча|	Ракевіч Мікалай Мікалаевіч
Ракуця Аляксандра Мікалаевіча|	Ракуць Аляксандр Мікалаевіч
Раманюка Генадзія Мікалаевіча|	Раманюк Генадзій Мікалаевіч
Рахман Святлану Мікалаеўну|	Рахман Святлана Мікалаеўна
Рога Уладзіміра Мікалаевіча|	Рог Уладзімір Мікалаевіч
Рудзя Вадзіма Уладзіміравіча|	Рудзь Вадзім Уладзіміравіч
Савіцкага Андрэя Іосіфавіча|	Савіцкі Андрэй Іосіфавіч
Салаўя Сяргея Яўгеньевіча|	Салаўь Сяргей Яўгеньевіч
Саладкова Івана Аляксандравіча|	Саладкоў Іван Аляксандравіч
Сідарава Мікалая Леанідавіча|	Сідараў Мікалай Леанідавіч
Сіманкова Міхаіла Уладзіміравіча|	Сіманкоў Міхаіл Уладзіміравіч
Скаўронскага Мікалая Уладзіміравіча|	Скаўронскі Мікалай Уладзіміравіч
Скопца Алега Віктаравіча|	Скопц Алег Віктаравіч
Скуратовіча Аляксандра Аляксандравіча|	Скуратовіч Аляксандр Аляксандравіч
Смірнова Аляксандра Юр’евіча|	Смірноў Аляксандр Юр’евіч
Сомава Андрэя Аляксандравіча|	Сомаў Андрэй Аляксандравіч
Старажэнку Алега Ігаравіча|	Старажэнка Алег Ігаравіч
Сявенку Аляксандра Віктаравіча|	Сявенка Аляксандр Віктаравіч
Сялюціна Уладзіміра Анатольевіча|	Сялюцін Уладзімір Анатольевіч
Сямко Вадзіма Анатольевіча|	Сямко Вадзім Анатольевіч
Траццяка Андрэя Аляксандравіча|	Траццяк Андрэй Аляксандравіч
Фалынскова Ігара Аляксеевіча|	Фалынскоў Ігар Аляксеевіч
Федаровіча Валерыя Сцефанавіча|	Федаровіч Валерый Сцефанавіч
Хмялеўскага Уладзіміра Яўгеньевіча|	Хмялеўскі Уладзімір Яўгеньевіч
Цвірко Аляксандра Васільевіча|	Цвірко Аляксандр Васільевіч
Чарненку Віталія Анатольевіча|	Чарненка Віталій Анатольевіч
Чарнышова Сяргея Міхайлавіча|	Чарнышоў Сяргей Міхайлавіч
Чарняўскую Ірыну Міхайлаўну|	Чарняўская Ірына Міхайлаўна
Чорнага Святаслава Мікалаевіча|	Чорны Святаслаў Мікалаевіч
Чумакова Яўгенія Мікалаевіча|	Чумакоў Яўгеній Мікалаевіч
Шаламая Пятра Іванавіча|	Шаламай Пётр Іванавіч
Шалкоўскага Паўла Аляксандравіча|	Шалкоўскі Павел Аляксандравіч
Шубадзёрава Сцяпана Генадзіевіча|	Шубадзёраў Сцяпан Генадзіевіч
Шыкіна Ігара Яўгеньевіча|	Шыкін Ігар Яўгеньевіч
Ягорава Юрыя Мікалаевіча|	Ягораў Юрый Мікалаевіч
Ярашука Генадзія Міхайлавіча|	Ярашук Генадзій Міхайлавіч
Ярмоліка Сяргея Мікалаевіча|	Ярмолік Сяргей Мікалаевіч
Ярука Дзмітрыя Уладзіміравіча|	Ярук Дзмітрый Уладзіміравіч
Ярушкіна Ілью Уладзіміравіча|	Ярушкін Ілья Уладзіміравіч
Яўковіча Мікалая Мікалаевіча|	Яўковіч Мікалай Мікалаевіч
Яўхуту Дзмітрыя Уладзіміравіча|	Яўхута Дзмітрый Уладзіміравіч
Бурдыка Аксану Генадзьеўну|	Бурдыка Аксана Генадзьеўна
Гарбачэўскую Ірыну Аляксандраўну|	Гарбачэўская Ірына Аляксандраўна
Захарэнкаву Таццяну Мікалаеўну|	Захарэнкава Таццяна Мікалаеўна
Зуеву Алену Мікалаеўну|	Зуева Алена Мікалаеўна
Кавалеўскую Юлію Леанідаўну|	Кавалеўская Юлія Леанідаўна
Кашко Таццяну Барысаўну|	Кашко Таццяна Барысаўна
Пятрушэнка Святлану Іванаўну|	Пятрушэнка Святлана Іванаўна
Тамашэвіч Тамару Мікалаеўну|	Тамашэвіч Тамара Мікалаеўна
Мелянчук Антаніну Антонаўну|	Мелянчук Антаніна Антонаўна
Сакевіч Вераніку Уладзіміраўну|	Сакевіч Вераніка Уладзіміраўна
Амбарцумян Таццяну Аляксандраўну|	Амбарцумян Таццяна Аляксандраўна
Асмыковіч Наталлю Уладзіміраўну|	Асмыковіч Наталля Уладзіміраўна
Глобаж Надзею Веніямінаўну|	Глобаж Надзея Веніямінаўна
Канапелька Лідзію Віктараўну|	Канапелька Лідзія Віктараўна
Кліменцьеву Ірыну Вячаславаўну|	Кліменцьева Ірына Вячаславаўна
Масанскую Таццяну Іванаўну|	Масанская Таццяна Іванаўна
Сабалеўскую Людмілу Мікалаеўну|	Сабалеўская Людміла Мікалаеўна
Тварагаль Наталлю Пятроўну|	Тварагаль Наталля Пятроўна
Шчацініну Віялету Уладзіміраўну|	Шчацініна Віялета Уладзіміраўна
Бабань Святлану Іванаўну|	Бабань Святлана Іванаўна
Генералаву Валянціну Уладзіміраўну|	Генералава Валянціна Уладзіміраўна
Кубрык Зінаіду Леанідаўну|	Кубрык Зінаіда Леанідаўна
Муквіча Уладзіміра Валер’евіча|	Муквіч Уладзімір Валер’евіч
Налівайку Сяргея Эдуардавіча|	Налівайка Сяргей Эдуардавіч
Новікаву Галіну Фёдараўну|	Новікава Галіна Фёдараўна
Саўко Алену Уладзіміраўну|	Саўко Алена Уладзіміраўна
Скрабатуна Пятра Сяменавіча|	Скрабатун Пётр Сяменавіч
Шыпалаву Яніну Казіміраўну|	Шыпалава Яніна Казіміраўна
Жаваранкаву Надзею Іванаўну|	Жаваранкава Надзея Іванаўна
Камянкова Уладзіміра Пятровіча|	Камянкоў Уладзімір Пятровіч
Канановіча Анатоля Лявонцьевіча|	Канановіч Анатоль Лявонцьевіч
Ляшчэню Аляксандра Іванавіча|	Ляшчэня Аляксандр Іванавіч
Мішчанку Мікалая Сцяпанавіча|	Мішчанка Мікалай Сцяпанавіч
Скіпара Міхаіла Аляксандравіча|	Скіпар Міхаіл Аляксандравіч
Царова Аляксандра Якаўлевіча|	Цароў Аляксандр Якаўлевіч
Папкевіча Уладзіміра Віктаравіча|	Папкевіч Уладзімір Віктаравіч
Пінчука Мікалая Іванавіча|	Пінчук Мікалай Іванавіч
Казеку Міхаіла Мікалаевіча|	Казека Міхаіл Мікалаевіч
Прэдку Юрыя Іванавіча|	Прэдка Юрый Іванавіч
Пакрышкіна Уладзіміра Іванавіча|	Пакрышкін Уладзімір Іванавіч
Лучанка Ігара Міхайлавіча|	Лучанок Ігар Міхайлавіч
Масіенку Юрыя Іванавіча|	Масіенка Юрый Іванавіч
Рыбіна Уладзіміра Іванавіча|	Рыбін Уладзімір Іванавіч
Навіцкага Андрэя Іосіфавіча|	Навіцкі Андрэй Іосіфавіч
Афончанку Пятра Іванавіча|	Афончанка Пётр Іванавіч
Бялоцкага Пятра Васільевіча|	Бялоцкі Пётр Васільевіч
Воўка Віталія Міхайлавіча|	Воўк Віталій Міхайлавіч
Кастраміцкага Сяргея Міхайлавіча|	Кастраміцкі Сяргей Міхайлавіч
Луцык Вольгу Аляксееўну|	Луцык Вольга Аляксееўна
Трафіменку Уладзіміра Паўлавіча|	Трафіменка Уладзімір Паўлавіч
Цэпкалу Валерыя Вільямавіча|	Цэпкала Валерый Вільямавіч
Аксёнава Пятра Іванавіча|	Аксёнаў Пётр Іванавіч
Быстрова Антона Альбертавіча|	Быстроў Антон Альбертавіч
Гурыновіча Антона Уладзіміравіча|	Гурыновіч Антон Уладзіміравіч
Пазднякова Ілью Сяргеевіча|	Пазднякоў Ілья Сяргеевіч
Грыднева Сяргея Міхайлавіча|	Грыднеў Сяргей Міхайлавіч
Астапука Юрыя Леанідавіча|	Астапук Юрый Леанідавіч
Астроўскага Дзмітрыя Ігаравіча|	Астроўскі Дзмітрый Ігаравіч
Ельніцкага Валерыя Аляксандравіча|	Ельніцкі Валерый Аляксандравіч
Заблоцкага Сяргея Віктаравіча|	Заблоцкі Сяргей Віктаравіч
Курзова Вячаслава Міхайлавіча|	Курзоў Вячаслаў Міхайлавіч
Лобаня Ігара Уладзіміравіча|	Лобань Ігар Уладзіміравіч
Мілешку Віктара Цімонавіча|	Мілешка Віктар Цімонавіч
Пракаповіча Яўгена Генадзьевіча|	Пракаповіч Яўген Генадзьевіч
Бабарыкіна Яўгенія Аляксандравіча|	Бабарыкін Яўгеній Аляксандравіч
Бароху Аляксандра Фёдаравіча|	Бароха Аляксандр Фёдаравіч
Беразюк Таццяну Сяргееўну|	Беразюк Таццяна Сяргееўна
Васількова Мікалая Андрэевіча|	Васількоў Мікалай Андрэевіч
Верамеюка Віктара Пятровіча|	Верамеюк Віктар Пятровіч
Верушэўскага Станіслава Альфонсавіча|	Верушэўскі Станіслаў Альфонсавіч
Віскушэнка Людмілу Міхайлаўну|	Віскушэнка Людміла Міхайлаўна
Гавінчык Людмілу Уладзіміраўну|	Гавінчык Людміла Уладзіміраўна
Галавача Андрэя Альбертавіча|	Галавач Андрэй Альбертавіч
Гардзея Валерыя Вітальевіча|	Гардзей Валерый Вітальевіч
Грэбнева Генадзя Іванавіча|	Грэбнеў Генадзь Іванавіч
Даніловіч Тамару Міхайлаўну|	Даніловіч Тамара Міхайлаўна
Добкіна Аркадзія Міхайлавіча|	Добкін Аркадзій Міхайлавіч
Дудараву Алену Уладзіміраўну|	Дударава Алена Уладзіміраўна
Кіслага Уладзіміра Іванавіча|	Кіслы Уладзімір Іванавіч
Кукраш Ганну Браніславаўну|	Кукраш Ганна Браніславаўна
Купрыянчык Ірыну Фёдараўну|	Купрыянчык Ірына Фёдараўна
Ламаку Аляксандра Віктаравіча|	Ламака Аляксандр Віктаравіч
Лынькова Леаніда Міхайлавіча|	Лынькоў Леанід Міхайлавіч
Макарэвіча Іосіфа Іосіфавіча|	Макарэвіч Іосіф Іосіфавіч
Мацюшэўскага Анатолія Пятровіча|	Мацюшэўскі Анатолій Пятровіч
Мукавозчыка Аляксандра Яўгеньевіча|	Мукавозчык Аляксандр Яўгеньевіч
Нівяркевіча Івана Іванавіча|	Нівяркевіч Іван Іванавіч
Пігунова Алега Іванавіча|	Пігуноў Алег Іванавіч
Сакалоўскага Алега Анатольевіча|	Сакалоўскі Алег Анатольевіч
Саладуху Віталія Аляксандравіча|	Саладуха Віталій Аляксандравіч
Смольскага Генадзя Аляксандравіча|	Смольскі Генадзь Аляксандравіч
Станавую Людмілу Спірыдонаўну|	Станавая Людміла Спірыдонаўна
Станкевіч Ганну Пятроўну|	Станкевіч Ганна Пятроўна
Халькова Васілія Фёдаравіча|	Халькоў Васілій Фёдаравіч
Чарнякоўскага Дзмітрыя Мікалаевіча|	Чарнякоўскі Дзмітрый Мікалаевіч
Юрчанку Мікалая Мікалаевіча|	Юрчанка Мікалай Мікалаевіч
Яшчука Мікалая Рыгоравіча|	Яшчук Мікалай Рыгоравіч
Бібік Ларысу Рыгораўну|	Бібік Ларыса Рыгораўна
Вашчулу Уладзіміра Мікалаевіча|	Вашчула Уладзімір Мікалаевіч
Героніка Канстанціна Леанідавіча|	Геронік Канстанцін Леанідавіч
Данілаву Ларысу Іванаўну|	Данілава Ларыса Іванаўна
Кошалева Уладзіміра Сяргеевіча|	Кошалеў Уладзімір Сяргеевіч
Леўданскую Алену Уладзіміраўну|	Леўданская Алена Уладзіміраўна
Лішчэнку Сяргея Юр’евіча|	Лішчэнка Сяргей Юр’евіч
Малыхіну Галіну Іванаўну|	Малыхіна Галіна Іванаўна
Праўдзівец Тамару Уладзіміраўну|	Праўдзівец Тамара Уладзіміраўна
Праўдзіна Віктара Аляксандравіча|	Праўдзін Віктар Аляксандравіч
Раманоўскую Марыну Генадзьеўну|	Раманоўская Марына Генадзьеўна
Сняжыцкага Віктара Алякcандравіча|	Сняжыцкі Віктар Алякcандравіч
Хітрову Людмілу Анатольеўну|	Хітрова Людміла Анатольеўна
Шапялевіча Васілія Васільевіча|	Шапялевіч Васілій Васільевіч
Шушкевіча Валерыя Мікалаевіча|	Шушкевіч Валерый Мікалаевіч
Шырко Васіля Аляксандравіча|	Шырко Васіль Аляксандравіч
Тустава Івана Фёдаравіча|	Тустаў Іван Фёдаравіч
Цішкевіч Вольгу Браніславаўну|	Цішкевіч Вольга Браніславаўна
Ваўрэнтовіча Мікалая Уладзіміравіча|	Ваўрэнтовіч Мікалай Уладзіміравіч
Журкова Пятра Якімавіча|	Журкоў Пётр Якімавіч
Козака Васілія Іосіфавіча|	Козак Васілій Іосіфавіч
Кравец Марыну Андрэеўну|	Кравец Марына Андрэеўна
Лабкова Мікалая Афанасьевіча|	Лабкоў Мікалай Афанасьевіч
Шышова Васілія Пятровіча|	Шышоў Васілій Пятровіч
Несцяровіча Віктара Антонавіча|	Несцяровіч Віктар Антонавіч
Антоненку Алега Уладзіміравіча|	Антоненка Алег Уладзіміравіч
Панамарова Сцяпана Анатольевіча|	Панамароў Сцяпан Анатольевіч
Цыплакова Уладзіміра Віктаравіча|	Цыплакоў Уладзімір Віктаравіч
Грышукевіча Леаніда Іванавіча|	Грышукевіч Леанід Іванавіч
Алешка Вікторыю Робертаўну|	Алешка Вікторыя Робертаўна
Сюльжыну Аэліту Іванаўну|	Сюльжына Аэліта Іванаўна
Эйсманта Івана Міхайлавіча|	Эйсмант Іван Міхайлавіч
Шмата Валерыя Сяргеевіча|	Шмат Валерый Сяргеевіч
Бекбулатава Вадзіма Мікалаевіча|	Бекбулатаў Вадзім Мікалаевіч
Баскава Дзмітрыя Юр’евіча|	Баскаў Дзмітрый Юр’евіч
Мікульчыка Алега Антонавіча|	Мікульчык Алег Антонавіч
Шыткоўскага Сяргея Сяргеевіча|	Шыткоўскі Сяргей Сяргеевіч
Бацэвічуса Віталія Гедзімінасавіча-Альбертасавіча|	Бацэвічус Віталій Гедзімінасавіча-Альбертасавіч
Герасімава Дзмітрыя Лявонцьевіча|	Герасімаў Дзмітрый Лявонцьевіч
Малашэвіча Ігара Іванавіча|	Малашэвіч Ігар Іванавіч
Маршалава Ігара Анатольевіча|	Маршалаў Ігар Анатольевіч
Селюна Аляксандра Пятровіча|	Селюн Аляксандр Пятровіч
Сімакова Ігара Мікалаевіча|	Сімакоў Ігар Мікалаевіч
Чэразова Аляксандра Сяргеевіча|	Чэразоў Аляксандр Сяргеевіч
Шаройкіна Аляксандра Міхайлавіча|	Шаройкін Аляксандр Міхайлавіч
Амельяновіча Аляксандра Рыгоравіча|	Амельяновіч Аляксандр Рыгоравіч
Андрухова Вячаслава Васільевіча|	Андрухоў Вячаслаў Васільевіч
Баркулак Святлану Уладзіміраўну|	Баркулак Святлана Уладзіміраўна
Бодзіча Анатолія Яўгеньевіча|	Бодзіч Анатолій Яўгеньевіч
Брэднева Анатолія Пятровіча|	Брэднеў Анатолій Пятровіч
Бубнова Ігара Мікалаевіча|	Бубноў Ігар Мікалаевіч
Бурава Юрыя Георгіевіча|	Бураў Юрый Георгіевіч
Бураўкова Аляксандра Вітальевіча|	Бураўкоў Аляксандр Вітальевіч
Бяляеву Раісу Аляксееўну|	Бяляева Раіса Аляксееўна
Воранава Уладзіміра Анатольевіча|	Воранаў Уладзімір Анатольевіч
Вярбіцкага Вадзіма Эдуардавіча|	Вярбіцкі Вадзім Эдуардавіч
Гаўрыцкага Андрэя Антонавіча|	Гаўрыцкі Андрэй Антонавіч
Глушца Віктара Васільевіча|	Глушц Віктар Васільевіч
Даўгучыц Галіну Мікалаеўну|	Даўгучыц Галіна Мікалаеўна
Дзенісенку Андрэя Фёдаравіча|	Дзенісенка Андрэй Фёдаравіч
Дробыша Станіслава Эдуардавіча|	Дробыш Станіслаў Эдуардавіч
Дудзенайце Святлану Аляксееўну|	Дудзенайце Святлана Аляксееўна
Калашнікава Сяргея Аляксеевіча|	Калашнікаў Сяргей Аляксеевіч
Камінскага Аляксандра Канстанцінавіча|	Камінскі Аляксандр Канстанцінавіч
Кашаева Паўла Уладзіміравіча|	Кашаеў Павел Уладзіміравіч
Кушаля Валерыя Яўгеньевіча|	Кушаль Валерый Яўгеньевіч
Маркіша Алега Часлававіча|	Маркіш Алег Часлававіч
Мельнікава Мікалая Яўгеньевіча|	Мельнікаў Мікалай Яўгеньевіч
Палько Ігара Пятровіча|	Палько Ігар Пятровіч
Пальчэха Уладзіміра Часлававіча|	Пальчэх Уладзімір Часлававіч
Панфілу Сяргея Міхайлавіча|	Панфіла Сяргей Міхайлавіч
Пётух Наталлю Іванаўну|	Пётух Наталля Іванаўна
Сокалава Андрэя Віктаравіча|	Сокалаў Андрэй Віктаравіч
Чэрніка Віталія Генадзевіча|	Чэрнік Віталій Генадзевіч
Шадрыну Ірыну Мікалаеўну|	Шадрына Ірына Мікалаеўна
Шацько Ігара Уладзіміравіча|	Шацько Ігар Уладзіміравіч
Кабякова Андрэя Уладзіміравіча|	Кабякоў Андрэй Уладзіміравіч
Вакульчыка Валерыя Паўлавіча|	Вакульчык Валерый Паўлавіч
Лаўрэнкова Генадзія Міхайлавіча|	Лаўрэнкоў Генадзій Міхайлавіч
Ярмошыну Лідзію Міхайлаўну|	Ярмошына Лідзія Міхайлаўна
Жадобіна Юрыя Віктаравіча|	Жадобін Юрый Віктаравіч
Шуневіча Ігара Анатольевіча|	Шуневіч Ігар Анатольевіч
Налівайка Алену Васільеўну|	Налівайка Алена Васільеўна
Таўрыкіна Уладзіміра Піліпавіча|	Таўрыкін Уладзімір Піліпавіч
Батуру Міхаіла Паўлавіча|	Батура Міхаіл Паўлавіч
Грушніка Пятра Пятровіча|	Грушнік Пётр Пятровіч
Івашкевіча Алега Анатольевіча|	Івашкевіч Алег Анатольевіч
Паліксенаву Валянціну Дзмітрыеўну|	Паліксенава Валянціна Дзмітрыеўна
Холад Галіну Іванаўну|	Холад Галіна Іванаўна
Лісічкіна Вячаслава Ігаравіча|	Лісічкін Вячаслаў Ігаравіч
Макрыцкага Аляксандра Пятровіча|	Макрыцкі Аляксандр Пятровіч
Малашкевіча Алега Аляксандравіча|	Малашкевіч Алег Аляксандравіч
Меленчука Уладзіміра Мікалаевіча|	Меленчук Уладзімір Мікалаевіч
Плотнікава Аляксея Уладзіміравіча|	Плотнікаў Аляксей Уладзіміравіч
Стася Сяргея Леанідавіча|	Стась Сяргей Леанідавіч
Шабанава Сяргея Рудольфавіча|	Шабанаў Сяргей Рудольфавіч
Валатоўскага Ігара Дзмітрыявіча|	Валатоўскі Ігар Дзмітрыявіч
Карпава Ігара Аляксандравіча|	Карпаў Ігар Аляксандравіч
Коўшыка Дзяніса Віктаравіча|	Коўшык Дзяніс Віктаравіч
Лабунова Уладзіміра Архіпавіча|	Лабуноў Уладзімір Архіпавіч
Ламана Мікалая Афанасьевіча|	Ламан Мікалай Афанасьевіч
Лосева Аляксандра Уладзіміравіча|	Лосеў Аляксандр Уладзіміравіч
Федаровіча Сяргея Аляксандравіча|	Федаровіч Сяргей Аляксандравіч
Вітко Аляксандра Аляксандравіча|	Вітко Аляксандр Аляксандравіч
Пухальскага Сяргея Уладзіміравіча|	Пухальскі Сяргей Уладзіміравіч
Бараніка Васілія Міхайлавіча|	Баранік Васілій Міхайлавіч
Красоўскага Сяргея Анатольевіча|	Красоўскі Сяргей Анатольевіч
Лебядзенку Валерыя Іванавіча|	Лебядзенка Валерый Іванавіч
Станілку Сцяпана Іванавіча|	Станілка Сцяпан Іванавіч
Смеяновіча Арнольда Фёдаравіча|	Смеяновіч Арнольд Фёдаравіч
Працэнку Сяргея Іванавіча|	Працэнка Сяргей Іванавіч
Фёдарава Ігара Леанідавіча|	Фёдараў Ігар Леанідавіч
Барысёнка Барыса Васільевіча|	Барысёнак Барыс Васільевіч
Вішнеўскага Міхаіла Іванавіча|	Вішнеўскі Міхаіл Іванавіч
Астраверхаву Ларысу Георгіеўну|	Астраверхава Ларыса Георгіеўна
Багам’ю Пятра Мікалаевіча|	Багам’я Пётр Мікалаевіч
Башуру Віктара Мікалаевіча|	Башура Віктар Мікалаевіч
Біліду Міхаіла Іванавіча|	Біліда Міхаіл Іванавіч
Галаўкова Алега Уладзіміравіча|	Галаўкоў Алег Уладзіміравіч
Ганчэнко Генадзія Юр’евіча|	Ганчэнко Генадзій Юр’евіч
Гойдзя Валерыя Іванавіча|	Гойдзь Валерый Іванавіч
Грышына Уладзіміра Васільевіча|	Грышын Уладзімір Васільевіч
Ермаловіча Анатолія Аляксеевіча|	Ермаловіч Анатолій Аляксеевіч
Жынко Аляксандра Яўгеньевіча|	Жынко Аляксандр Яўгеньевіч
Захарэнку Віктара Канстанцінавіча|	Захарэнка Віктар Канстанцінавіч
Казачонка Аляксандра Дзмітрыевіча|	Казачонак Аляксандр Дзмітрыевіч
Казлоўскага Уладзіміра Мікалаевіча|	Казлоўскі Уладзімір Мікалаевіч
Кануса Альгірдаса Васільевіча|	Канус Альгірдас Васільевіч
Карымава Роберта Мірзаджанавіча|	Карымаў Роберт Мірзаджанавіч
Крохмаля Яўгенія Іосіфавіча|	Крохмаль Яўгеній Іосіфавіч
Крывенькага Сямёна Сямёнавіча|	Крывенькі Сямён Сямёнавіч
Курачова Аляксандра Віктаравіча|	Курачоў Аляксандр Віктаравіч
Мазырку Аляксея Аляксеевіча|	Мазырка Аляксей Аляксеевіч
Марзалюка Ігара Аляксандравіча|	Марзалюк Ігар Аляксандравіч
Маціеўскага Леаніда Антонавіча|	Маціеўскі Леанід Антонавіч
Меметава Джафера Ісмаілавіча|	Меметаў Джафер Ісмаілавіч
Нягоцкую Алену Леанідаўну|	Нягоцкая Алена Леанідаўна
Петручэню Юрыя Мікалаевіча|	Петручэня Юрый Мікалаевіч
Піваварчыка Міхаіла Іванавіча|	Піваварчык Міхаіл Іванавіч
Пучкоўскага Мікалая Мікалаевіча|	Пучкоўскі Мікалай Мікалаевіч
Радкевіча Мікалая Анатольевіча|	Радкевіч Мікалай Анатольевіч
Ражко Аляксандра Валянцінавіча|	Ражко Аляксандр Валянцінавіч
Стэльмаха Васіля Сцяпанавіча|	Стэльмах Васіль Сцяпанавіч
Сухарэўскага Мікалая Раманавіча|	Сухарэўскі Мікалай Раманавіч
Тачонага Валянціна Ігнацьевіча|	Тачоны Валянцін Ігнацьевіч
Умінскага Уладзіміра Іосіфавіча|	Умінскі Уладзімір Іосіфавіч
Чыжа Пятра Уладзіміравіча|	Чыж Пётр Уладзіміравіч
Чэмармазовіча Генадзія Станіслававіча|	Чэмармазовіч Генадзій Станіслававіч
Шпакава Валерыя Васільевіча|	Шпакаў Валерый Васільевіч
Афанасенка Валянціну Гаўрыілаўну|	Афанасенка Валянціна Гаўрыілаўна
Васюка Уладзіміра Уладзіміравіча|	Васюк Уладзімір Уладзіміравіч
Кемброўскага Генадзія Станіслававіча|	Кемброўскі Генадзій Станіслававіч
Марахоўскага Юрыя Харытонавіча|	Марахоўскі Юрый Харытонавіч
Наумаву Людмілу Іванаўну|	Наумава Людміла Іванаўна
Паражняка Тараса Мікалаевіча|	Паражняк Тарас Мікалаевіч
Собаля Анатолія Анатольевіча|	Собаль Анатолій Анатольевіч
Старавойтава Леаніда Яўгеньевіча|	Старавойтаў Леанід Яўгеньевіч
Суруса Рыгора Фёдаравіча|	Сурус Рыгор Фёдаравіч
Сцепанкову Ганну Аляксееўну|	Сцепанкова Ганна Аляксееўна
Фінскага Аляксандра Міхайлавіча|	Фінскі Аляксандр Міхайлавіч
Акінчыц Алену Антонаўну|	Акінчыц Алена Антонаўна
Вавілкіну Аксану Валер’еўну|	Вавілкіна Аксана Валер’еўна
Важэйка Алену Пятроўну|	Важэйка Алена Пятроўна
Вярэніч Анастассю Мікалаеўну|	Вярэніч Анастасся Мікалаеўна
Гаргун Валянціну Мікалаеўну|	Гаргун Валянціна Мікалаеўна
Гелец Таісу Сцяпанаўну|	Гелец Таіса Сцяпанаўна
Грэбчук Іну Мікалаеўну|	Грэбчук Іна Мікалаеўна
Дзямковіч Людмілу Рыгораўну|	Дзямковіч Людміла Рыгораўна
Зарэмба Ірыну Лявонцьеўну|	Зарэмба Ірына Лявонцьеўна
Ільючык Валянціну Іванаўну|	Ільючык Валянціна Іванаўна
Ільючык Вольгу Сцяпанаўну|	Ільючык Вольга Сцяпанаўна
Кавалевіч Юлію Пятроўну|	Кавалевіч Юлія Пятроўна
Кажаноўскую Настассю Міхайлаўну|	Кажаноўская Настасся Міхайлаўна
Калеснікаву Аксану Васільеўну|	Калеснікава Аксана Васільеўна
Кананец Таісію Паўлаўну|	Кананец Таісія Паўлаўна
Карнялюк Алену Іванаўну|	Карнялюк Алена Іванаўна
Карпаву Таццяну Уладзіміраўну|	Карпава Таццяна Уладзіміраўна
Катовіч Галіну Паўлаўну|	Катовіч Галіна Паўлаўна
Кінчак Марыю Іванаўну|	Кінчак Марыя Іванаўна
Клопат Любоў Іванаўну|	Клопат Любоў Іванаўна
Кутавенка Ірыну Дзмітрыеўну|	Кутавенка Ірына Дзмітрыеўна
Кухарчук Людмілу Васільеўну|	Кухарчук Людміла Васільеўна
Латышэвіч Іну Міхайлаўну|	Латышэвіч Іна Міхайлаўна
Ленінец Наталлю Станіславаўну|	Ленінец Наталля Станіславаўна
Лук’янчук Валянціну Аляксееўну|	Лук’янчук Валянціна Аляксееўна
Любіч Аксану Анатольеўну|	Любіч Аксана Анатольеўна
Мамайка Наталлю Уладзіміраўну|	Мамайка Наталля Уладзіміраўна
Мартынюк Наталлю Уладзіміраўну|	Мартынюк Наталля Уладзіміраўна
Мацукевіч Таццяну Рыгораўну|	Мацукевіч Таццяна Рыгораўна
Мельянец Наталлю Мікалаеўну|	Мельянец Наталля Мікалаеўна
Наскевіч Надзею Міхайлаўну|	Наскевіч Надзея Міхайлаўна
Несцераву Алу Іванаўну|	Несцерава Ала Іванаўна
Нікончык Галіну Аляксееўну|	Нікончык Галіна Аляксееўна
Нічыпарук Вольгу Міхайлаўну|	Нічыпарук Вольга Міхайлаўна
Ражкавец Таццяну Мікалаеўну|	Ражкавец Таццяна Мікалаеўна
Рыжук Вольгу Цімафееўну|	Рыжук Вольга Цімафееўна
Саган Алесю Міхайлаўну|	Саган Алеся Міхайлаўна
Суславу Людмілу Уладзіміраўну|	Суслава Людміла Уладзіміраўна
Тарасюк Аксану Аляксандраўну|	Тарасюк Аксана Аляксандраўна
Таруц Алену Мікалаеўну|	Таруц Алена Мікалаеўна
Халадовіч Ганну Аляксееўну|	Халадовіч Ганна Аляксееўна
Цыбульскас Наталію Іосіфаўну|	Цыбульскас Наталія Іосіфаўна
Чынікайла Зінаіду Аляксееўну|	Чынікайла Зінаіда Аляксееўна
Шаповіч Юлію Фёдараўну|	Шаповіч Юлія Фёдараўна
Шчурок Святлану Міхайлаўну|	Шчурок Святлана Міхайлаўна
Шылец Наталлю Міхайлаўну|	Шылец Наталля Міхайлаўна
Шыхараву Ірыну Мікалаеўну|	Шыхарава Ірына Мікалаеўна
Шыян Таццяну Аляксандраўну|	Шыян Таццяна Аляксандраўна
Шэшка Таццяну Мікалаеўну|	Шэшка Таццяна Мікалаеўна
Юрко Вольгу Уладзіміраўну|	Юрко Вольга Уладзіміраўна
Ярашэвіч Наталію Васільеўну|	Ярашэвіч Наталія Васільеўна
Яцушкевіч Наталлю Мікалаеўну|	Яцушкевіч Наталля Мікалаеўна
Агафонаву Ганну Васільеўну|	Агафонава Ганна Васільеўна
Бялову Таццяну Барысаўну|	Бялова Таццяна Барысаўна
Дайлідзёнак Таццяну Віктараўну|	Дайлідзёнак Таццяна Віктараўна
Камінскую Таццяну Валер’еўну|	Камінская Таццяна Валер’еўна
Кірылаву Вольгу Уладзіміраўну|	Кірылава Вольга Уладзіміраўна
Тарбецкую Ірыну Аляксандраўну|	Тарбецкая Ірына Аляксандраўна
Трафімаву Наталлю Мікалаеўну|	Трафімава Наталля Мікалаеўна
Фядосенка Надзею Уладзіміраўну|	Фядосенка Надзея Уладзіміраўна
Чаркасаву Алену Аляксееўну|	Чаркасава Алена Аляксееўна
Белаусаву Таццяну Пятроўну|	Белаусава Таццяна Пятроўна
Захараву Валянціну Васільеўну|	Захарава Валянціна Васільеўна
Канаш Вольгу Аляксандраўну|	Канаш Вольга Аляксандраўна
Красічэнка Алесю Дзмітрыеўну|	Красічэнка Алеся Дзмітрыеўна
Пікас Наталлю Мікалаеўну|	Пікас Наталля Мікалаеўна
Саламашанка Вольгу Яўгеньеўну|	Саламашанка Вольга Яўгеньеўна
Шчука Алену Васільеўну|	Шчука Алена Васільеўна
Буймістраву Вольгу Уладзіміраўну|	Буймістрава Вольга Уладзіміраўна
Канторшчыкаву Тамару Іванаўну|	Канторшчыкава Тамара Іванаўна
Максімаву Надзею Міхайлаўну|	Максімава Надзея Міхайлаўна
Саўчанка Жану Пятроўну|	Саўчанка Жана Пятроўна
Арцішэўскую Таццяну Іванаўну|	Арцішэўская Таццяна Іванаўна
Барылюк Наталлю Іванаўну|	Барылюк Наталля Іванаўна
Вішнеўскую Алену Іосіфаўну|	Вішнеўская Алена Іосіфаўна
Гайковіч Таццяну Чаславаўну|	Гайковіч Таццяна Чаславаўна
Герасімовіч Вольгу Аркадзьеўну|	Герасімовіч Вольга Аркадзьеўна
Грыгаркевіч Святлану Аляксандраўну|	Грыгаркевіч Святлана Аляксандраўна
Дзямідаву Святлану Мікалаеўну|	Дзямідава Святлана Мікалаеўна
Камінскую Таццяну Васільеўну|	Камінская Таццяна Васільеўна
Канановіч Зою Пятроўну|	Канановіч Зоя Пятроўна
Маславу Наталлю Мікалаеўну|	Маслава Наталля Мікалаеўна
Матвеенка Вольгу Міхайлаўну|	Матвеенка Вольга Міхайлаўна
Рындзевіч Марыну Аляксандраўну|	Рындзевіч Марына Аляксандраўна
Сандрозд Надзежду Іванаўну|	Сандрозд Надзежда Іванаўна
Татарынцаву Анастасію Барысаўну|	Татарынцава Анастасія Барысаўна
Тымановіч Наталлю Ігараўну|	Тымановіч Наталля Ігараўна
Цімашэнка Вікторыю Віктараўну|	Цімашэнка Вікторыя Віктараўна
Яблонскую Таццяну Фёдараўну|	Яблонская Таццяна Фёдараўна
Буйлянкова Алега Віктаравіча|	Буйлянкоў Алег Віктаравіч
Галухіна Віктара Аляксандравіча|	Галухін Віктар Аляксандравіч
Ганчара Юрыя Віктаравіча|	Ганчар Юрый Віктаравіч
Давідовіча Сяргея Віктаравіча|	Давідовіч Сяргей Віктаравіч
Дзядуля Леаніда Францавіча|	Дзядуль Леанід Францавіч
Жыўня Генадзія Адольфавіча|	Жыўнь Генадзій Адольфавіч
Ільюхіна Андрэя Юр’евіча|	Ільюхін Андрэй Юр’евіч
Качурынскага Валянціна Фёдаравіча|	Качурынскі Валянцін Фёдаравіч
Кобрусева Аляксандра Аркадзьевіча|	Кобрусеў Аляксандр Аркадзьевіч
Лепяшко Генадзія Уладзіміравіча|	Лепяшко Генадзій Уладзіміравіч
Ліпаўку Валерыя Уладзіміравіча|	Ліпаўка Валерый Уладзіміравіч
Лісоўскага Віталія Іванавіча|	Лісоўскі Віталій Іванавіч
Мазалеўскага Андрэя Барысавіча|	Мазалеўскі Андрэй Барысавіч
Панёўкіна Васілія Васільевіча|	Панёўкін Васілій Васільевіч
Парфенянкова Юрыя Віктаравіча|	Парфенянкоў Юрый Віктаравіч
Паўлава Уладзіміра Іванавіча|	Паўлаў Уладзімір Іванавіч
Позіна Алега Якаўлевіча|	Позін Алег Якаўлевіч
Ракусава Аляксандра Іванавіча|	Ракусаў Аляксандр Іванавіч
Сліжа Андрэя Казіміравіча|	Сліж Андрэй Казіміравіч
Татарко Ігара Фёдаравіча|	Татарко Ігар Фёдаравіч
Чэпіка Аляксандра Уладзіміравіча|	Чэпік Аляксандр Уладзіміравіч
Шэрснёва Ігара Іванавіча|	Шэрснёў Ігар Іванавіч
Акуліч Алену Уладзіміраўну|	Акуліч Алена Уладзіміраўна
Аляксандрава Ігара Аляксандравіча|	Аляксандраў Ігар Аляксандравіч
Андруховіча Кірыла Леанідавіча|	Андруховіч Кірыл Леанідавіч
Анціпенку Уладзіміра Іванавіча|	Анціпенка Уладзімір Іванавіч
Арочку Сяргея Міхайлавіча|	Арочка Сяргей Міхайлавіч
Арцем’ева Паўла Віктаравіча|	Арцем’еў Павел Віктаравіч
Асьмічэнку Віталія Віктаравіча|	Асьмічэнка Віталій Віктаравіч
Бабахіну Антаніну Яўгеньеўну|	Бабахіна Антаніна Яўгеньеўна
Бажко Сяргея Васільевіча|	Бажко Сяргей Васільевіч
Байнова Ігара Сяргеевіча|	Байноў Ігар Сяргеевіч
Башана Аляксея Уладзіміравіча|	Башан Аляксей Уладзіміравіч
Бегуна Дзмітрыя Міхайлавіча|	Бегун Дзмітрый Міхайлавіч
Белакапытава Вячаслава Мікалаевіча|	Белакапытаў Вячаслаў Мікалаевіч
Бурака Аляксандра Андрэевіча|	Бурак Аляксандр Андрэевіч
Бурбіцкага Аляксандра Пятровіча|	Бурбіцкі Аляксандр Пятровіч
Візера Алега Мікалаевіча|	Візер Алег Мікалаевіч
Галенку Андрэя Леанідавіча|	Галенка Андрэй Леанідавіч
Ганчарука Віталія Іванавіча|	Ганчарук Віталій Іванавіч
Гарбаненку Віталія Віктаравіча|	Гарбаненка Віталій Віктаравіч
Гардзевіча Сяргея Валянцінавіча|	Гардзевіч Сяргей Валянцінавіч
Гарэлава Сяргея Уладзіміравіча|	Гарэлаў Сяргей Уладзіміравіч
Гаўраніна Андрэя Міхайлавіча|	Гаўранін Андрэй Міхайлавіч
Герасіменку Вадзіма Уладзіміравіча|	Герасіменка Вадзім Уладзіміравіч
Гладзейчука Уладзіміра Уладзіміравіча|	Гладзейчук Уладзімір Уладзіміравіч
Глушкова Дзмітрыя Барысавіча|	Глушкоў Дзмітрый Барысавіч
Горбеля Юрыя Леанідавіча|	Горбель Юрый Леанідавіч
Грыгарэвіча Казіміра Уладзіміравіча|	Грыгарэвіч Казімір Уладзіміравіч
Грыдзюшку Паўла Уладзіміравіча|	Грыдзюшка Павел Уладзіміравіч
Дзямідава Леаніда Васільевіча|	Дзямідаў Леанід Васільевіч
Дразда Ігара Мікалаевіча|	Дразд Ігар Мікалаевіч
Драздову Святлану Мікалаеўну|	Драздова Святлана Мікалаеўна
Дудкіна Анатолія Канстанцінавіча|	Дудкін Анатолій Канстанцінавіч
Ждана Віктара Віктаравіча|	Ждан Віктар Віктаравіч
Жылко Дзяніса Валянцінавіча|	Жылко Дзяніс Валянцінавіч
Зданевіча Андрэя Іванавіча|	Зданевіч Андрэй Іванавіч
Іванова Сяргея Аляксеевіча|	Іваноў Сяргей Аляксеевіч
Ісайкова Алега Валянцінавіча|	Ісайкоў Алег Валянцінавіч
Кабрынца Сяргея Дзмітрыевіча|	Кабрынец Сяргей Дзмітрыевіч
Казакова Аляксандра Анатольевіча|	Казакоў Аляксандр Анатольевіч
Казлова Віталя Яўгенавіча|	Казлоў Віталь Яўгенавіч
Казлоўскіх Аляксандра Леанідавіча|	Казлоўскіх Аляксандр Леанідавіч
Каласоўскага Андрэя Мікалаевіча|	Каласоўскі Андрэй Мікалаевіч
Каліту Ігара Аляксандравіча|	Каліта Ігар Аляксандравіч
Карніенку Сяргея Васільевіча|	Карніенка Сяргей Васільевіч
Кастрыцу Спартака Леанідавіча|	Кастрыца Спартак Леанідавіч
Качамасава Максіма Віктаравіча|	Качамасаў Максім Віктаравіч
Кісяля Дзмітрыя Міхайлавіча|	Кісяль Дзмітрый Міхайлавіч
Клімовіча Міхаіла Лукіча|	Клімовіч Міхаіл Лукіч
Клімчэню Вячаслава Сяргеевіча|	Клімчэня Вячаслаў Сяргеевіч
Крываноса Мікалая Анатольевіча|	Крыванос Мікалай Анатольевіч
Крываносава Андрэя Уладзіміравіча|	Крываносаў Андрэй Уладзіміравіч
Крыўко Яўгенія Іванавіча|	Крыўко Яўгеній Іванавіч
Крэпскага Максіма Іванавіча|	Крэпскі Максім Іванавіч
Ксенафонтава Уладзіслава Анатольевіча|	Ксенафонтаў Уладзіслаў Анатольевіч
Лазарава Ігара Іванавіча|	Лазараў Ігар Іванавіч
Лахая Леаніда Іванавіча|	Лахай Леанід Іванавіч
Лашчынскага Сяргея Аляксандравіча|	Лашчынскі Сяргей Аляксандравіч
Ліхаманава Руслана Юр’евіча|	Ліхаманаў Руслан Юр’евіч
Лукашэвіча Аляксандра Іосіфавіча|	Лукашэвіч Аляксандр Іосіфавіч
Лыпавага Сяргея Барысавіча|	Лыпавы Сяргей Барысавіч
Мажылоўскага Ігара Уладзіміравіча|	Мажылоўскі Ігар Уладзіміравіч
Майсака Віктара Канстанцінавіча|	Майсак Віктар Канстанцінавіч
Макарэвіча Аляксандра Аляксандравіча|	Макарэвіч Аляксандр Аляксандравіч
Макарэвіча Аляксандра Міхайлавіча|	Макарэвіч Аляксандр Міхайлавіч
Малаковіча Сяргея Міхайлавіча|	Малаковіч Сяргей Міхайлавіч
Мамоценку Аляксея Арнольдавіча|	Мамоценка Аляксей Арнольдавіч
Мікуліча Сяргея Леанідавіча|	Мікуліч Сяргей Леанідавіч
Міхеева Віктара Васільевіча|	Міхееў Віктар Васільевіч
Наўцэню Сяргея Уладзіміравіча|	Наўцэня Сяргей Уладзіміравіч
Неўдаха Дзмітрыя Аляксандравіча|	Неўдах Дзмітрый Аляксандравіч
Пармон Наталлю Ігараўну|	Пармон Наталля Ігараўна
Пенцяка Паўла Пятровіча|	Пенцяк Павел Пятровіч
Петрачука Віктара Паўлавіча|	Петрачук Віктар Паўлавіч
Плішкіна Алега Уладзіміравіча|	Плішкін Алег Уладзіміравіч
Полазава Ігара Міхайлавіча|	Полазаў Ігар Міхайлавіч
Прыдачу Андрэя Уладзіміравіча|	Прыдача Андрэй Уладзіміравіч
Пятрова Сяргея Барысавіча|	Пятроў Сяргей Барысавіч
Ракецкага Сяргея Іванавіча|	Ракецкі Сяргей Іванавіч
Раманоўскага Аляксандра Рамуальдавіча|	Раманоўскі Аляксандр Рамуальдавіч
Рашчупкіна Уладзіслава Уладзіміравіча|	Рашчупкін Уладзіслаў Уладзіміравіч
Ромаша Сяргея Тадэвушавіча|	Ромаш Сяргей Тадэвушавіч
Рубіна Аляксандра Мікалаевіча|	Рубін Аляксандр Мікалаевіч
Русецкага Сяргея Генадзьевіча|	Русецкі Сяргей Генадзьевіч
Русецкага Юрыя Генадзьевіча|	Русецкі Юрый Генадзьевіч
Рыбальчанку Андрэя Сяргеевіча|	Рыбальчанка Андрэй Сяргеевіч
Сабліна Івана Васільевіча|	Саблін Іван Васільевіч
Сака Сямёна Пятровіча|	Сак Сямён Пятровіч
Санько Васілія Аляксандравіча|	Санько Васілій Аляксандравіч
Сугака Аляксандра Міхайлавіча|	Сугак Аляксандр Міхайлавіч
Сугака Віктара Іванавіча|	Сугак Віктар Іванавіч
Сцяпуру Уладзіміра Віктаравіча|	Сцяпура Уладзімір Віктаравіч
Сяргіенку Юрыя Уладзіміравіча|	Сяргіенка Юрый Уладзіміравіч
Токарава Ігара Анатольевіча|	Токараў Ігар Анатольевіч
Тузава Юрыя Аляксеевіча|	Тузаў Юрый Аляксеевіч
Тураўца Андрэя Валер’евіча|	Туравец Андрэй Валер’евіч
Фаменку Анатоля Рыгоравіча|	Фаменка Анатоль Рыгоравіч
Філатава Сяргея Уладзіміравіча|	Філатаў Сяргей Уладзіміравіч
Хаванскага Вадзіма Міхайлавіча|	Хаванскі Вадзім Міхайлавіч
Цара Аляксандра Мікалаевіча|	Цар Аляксандр Мікалаевіч
Цімошыка Валерыя Казіміравіча|	Цімошык Валерый Казіміравіч
Чырко Андрэя Пятровіча|	Чырко Андрэй Пятровіч
Шэмета Максіма Міхайлавіча|	Шэмет Максім Міхайлавіч
Ярашука Аляксея Аляксандравіча|	Ярашук Аляксей Аляксандравіч
Ячыкава Аляксандра Аляксандравіча|	Ячыкаў Аляксандр Аляксандравіч
Абрамовіча Максіма Леанідавіча|	Абрамовіч Максім Леанідавіч
Адзіночанку Ігара Віктаравіча|	Адзіночанка Ігар Віктаравіч
Азарава Сяргея Мікалаевіча|	Азараў Сяргей Мікалаевіч
Азарку Алега Іванавіча|	Азарка Алег Іванавіч
Акрэсціна Ігара Уладзіміравіча|	Акрэсцін Ігар Уладзіміравіч
Акуневіча Алега Уладзіміравіча|	Акуневіч Алег Уладзіміравіч
Алейніка Валерыя Віктаравіча|	Алейнік Валерый Віктаравіч
Александровіча Алега Антонавіча|	Александровіч Алег Антонавіч
Алешковіча Ігара Міхайлавіча|	Алешковіч Ігар Міхайлавіч
Алешчука Мікалая Мікалаевіча|	Алешчук Мікалай Мікалаевіч
Амінава Міхаіла Радзікавіча|	Амінаў Міхаіл Радзікавіч
Андрушку Юрыя Іосіфавіча|	Андрушка Юрый Іосіфавіч
Андрэенку Канстанціна Валянцінавіча|	Андрэенка Канстанцін Валянцінавіч
Антоненку Ігара Уладзіміравіча|	Антоненка Ігар Уладзіміравіч
Анцыпава Дзмітрыя Уладзіміравіча|	Анцыпаў Дзмітрый Уладзіміравіч
Апалоніка Уладзіміра Вячаслававіча|	Апалонік Уладзімір Вячаслававіч
Арастовіча Дзмітрыя Мікалаевіча|	Арастовіч Дзмітрый Мікалаевіч
Асадчага Аляксандра Анатольевіча|	Асадчы Аляксандр Анатольевіч
Астапенку Сяргея Васільевіча|	Астапенка Сяргей Васільевіч
Аўлічава Аляксея Анатольевіча|	Аўлічаў Аляксей Анатольевіч
Аўсянікава Яўгенія Анатольевіча|	Аўсянікаў Яўгеній Анатольевіч
Аўчыннікава Дзмітрыя Пятровіча|	Аўчыннікаў Дзмітрый Пятровіч
Аўчыннікаву Алену Анатольеўну|	Аўчыннікава Алена Анатольеўна
Афанасенку Валерыя Яўгеньевіча|	Афанасенка Валерый Яўгеньевіч
Афанасенку Віктара Мікалаевіча|	Афанасенка Віктар Мікалаевіч
Ацьмана Сяргея Віктаравіча|	Ацьман Сяргей Віктаравіч
Багушэвіча Андрэя Алегавіча|	Багушэвіч Андрэй Алегавіч
Бадунова Уладзіміра Васільевіча|	Бадуноў Уладзімір Васільевіч
Бажко Анатолія Міхайлавіча|	Бажко Анатолій Міхайлавіч
Бакуна Аляксандра Уладзіміравіча|	Бакун Аляксандр Уладзіміравіч
Балцэвіча Аляксандра Мікалаевіча|	Балцэвіч Аляксандр Мікалаевіч
Балянкова Аляксандра Міхайлавіча|	Балянкоў Аляксандр Міхайлавіч
Бандарыка Міхаіла Міхайлавіча|	Бандарык Міхаіл Міхайлавіч
Бандарэнка Наталлю Віктараўну|	Бандарэнка Наталля Віктараўна
Бандарэнку Мікалая Мікалаевіча|	Бандарэнка Мікалай Мікалаевіч
Баразну Міхаіла Віктаравіча|	Баразна Міхаіл Віктаравіч
Баранава Ігара Дзмітрыевіча|	Баранаў Ігар Дзмітрыевіч
Барзакоўскага Сяргея Мікалаевіча|	Барзакоўскі Сяргей Мікалаевіч
Бародзіча Ігара Васільевіча|	Бародзіч Ігар Васільевіч
Барцэвіча Максіма Анатольевіча|	Барцэвіч Максім Анатольевіч
Барысава Андрэя Анатольевіча|	Барысаў Андрэй Анатольевіч
Барысаву Людмілу Генадзьеўну|	Барысава Людміла Генадзьеўна
Батана Уладзіміра Уладзіміравіча|	Батан Уладзімір Уладзіміравіч
Батуру Аляксандра Анатольевіча|	Батура Аляксандр Анатольевіч
Белашыцкага Аляксея Пятровіча|	Белашыцкі Аляксей Пятровіч
Беляшова Дзмітрыя Васільевіча|	Беляшоў Дзмітрый Васільевіч
Біласа Алега Уладзіміравіча|	Білас Алег Уладзіміравіч
Блізняца Пятра Пятровіча|	Блізняц Пётр Пятровіч
Бойку Сяргея Віктаравіча|	Бойка Сяргей Віктаравіч
Бондарава Віталія Аляксеевіча|	Бондараў Віталій Аляксеевіч
Бракарэнку Сяргея Аляксандравіча|	Бракарэнка Сяргей Аляксандравіч
Братчэню Сяргея Рыгоравіча|	Братчэня Сяргей Рыгоравіч
Брытвіча Дзмітрыя Уладзіміравіча|	Брытвіч Дзмітрый Уладзіміравіч
Брэля Аляксандра Фёдаравіча|	Брэль Аляксандр Фёдаравіч
Брэскага Дзмітрыя Валянцінавіча|	Брэскі Дзмітрый Валянцінавіч
Бубна Ігара Віктаравіча|	Бубн Ігар Віктаравіч
Бубнова Андрэя Генадзьевіча|	Бубноў Андрэй Генадзьевіч
Буднік Людмілу Віктараўну|	Буднік Людміла Віктараўна
Будрэвіча Аляксандра Віктаравіча|	Будрэвіч Аляксандр Віктаравіч
Булахава Валерыя Фёдаравіча|	Булахаў Валерый Фёдаравіч
Булву Аляксандра Дзмітрыевіча|	Булва Аляксандр Дзмітрыевіч
Бурдзюка Дзмітрыя Яўгеньевіча|	Бурдзюк Дзмітрый Яўгеньевіч
Бурнаса Юрыя Віктаравіча|	Бурнас Юрый Віктаравіч
Буткоўскую Марыну Васільеўну|	Буткоўская Марына Васільеўна
Быка Вячаслава Іванавіча|	Бык Вячаслаў Іванавіч
Бычкова Аляксандра Уладзіміравіча|	Бычкоў Аляксандр Уладзіміравіч
Бычкоўскага Юрыя Вайцехавіча|	Бычкоўскі Юрый Вайцехавіч
Бялко Аляксандра Пятровіча|	Бялко Аляксандр Пятровіч
Вайніловіча Валерыя Іванавіча|	Вайніловіч Валерый Іванавіч
Валасача Мікалая Мікалаевіча|	Валасач Мікалай Мікалаевіч
Валентукевіча Віктара Іосіфавіча|	Валентукевіч Віктар Іосіфавіч
Валенцюкевіча Паўла Валер’евіча|	Валенцюкевіч Павел Валер’евіч
Валошчыка Міхаіла Васільевіча|	Валошчык Міхаіл Васільевіч
Валошыну Алену Уладзіміраўну|	Валошына Алена Уладзіміраўна
Валуевіча Эдуарда Валянцінавіча|	Валуевіч Эдуард Валянцінавіч
Валынца Сяргея Іванавіча|	Валынец Сяргей Іванавіч
Вараб’ёва Віктара Міхайлавіча|	Вараб’ёў Віктар Міхайлавіч
Вараб’ёва Дзмітрыя Сяргеевіча|	Вараб’ёў Дзмітрый Сяргеевіч
Варанцова Віталя Уладзіміравіча|	Варанцоў Віталь Уладзіміравіч
Варанчука Андрэя Віктаравіча|	Варанчук Андрэй Віктаравіч
Варушылу Васілія Пятровіча|	Варушыла Васілій Пятровіч
Васілевіча Дзяніса Сяргеевіча|	Васілевіч Дзяніс Сяргеевіч
Васіленка Алену Мікалаеўну|	Васіленка Алена Мікалаеўна
Васілеўскага Васілія Міхайлавіча|	Васілеўскі Васілій Міхайлавіч
Васіна Васілія Віктаравіча|	Васін Васілій Віктаравіч
Васкабоеву Нону Леанідаўну|	Васкабоева Нона Леанідаўна
Васюка Андрэя Мечыслававіча|	Васюк Андрэй Мечыслававіч
Васюкевіча Аляксандра Сяргеевіча|	Васюкевіч Аляксандр Сяргеевіч
Ваўчка Віталія Вітальевіча|	Ваўчк Віталій Вітальевіч
Вашчанку Аляксандра Міхайлавіча|	Вашчанка Аляксандр Міхайлавіч
Вебера Аляксандра Аляксандравіча|	Вебер Аляксандр Аляксандравіч
Века Тамару Дзям’янаўну|	Века Тамара Дзям’янаўна
Венскага Валерыя Міхайлавіча|	Венскі Валерый Міхайлавіч
Верамейчыка Аляксандра Леанідавіча|	Верамейчык Аляксандр Леанідавіч
Верамейчыка Сяргея Валянцінавіча|	Верамейчык Сяргей Валянцінавіч
Вечара Уладзіміра Аркадзьевіча|	Вечар Уладзімір Аркадзьевіч
Вінакурава Андрэя Мікалаевіча|	Вінакураў Андрэй Мікалаевіч
Волкава Міхаіла Міхайлавіча|	Волкаў Міхаіл Міхайлавіч
Выгляда Алега Дзмітрыевіча|	Выгляд Алег Дзмітрыевіч
Высоцкага Аляксандра Яўгеньевіча|	Высоцкі Аляксандр Яўгеньевіч
Высоцкага Андрэя Васільевіча|	Высоцкі Андрэй Васільевіч
Выхоту Кірыла Сяргеевіча|	Выхота Кірыл Сяргеевіч
Вягеру Аляксандра Уладзіміравіча|	Вягера Аляксандр Уладзіміравіч
Вялічку Ігара Віктаравіча|	Вялічка Ігар Віктаравіч
Вярлова Віталія Генадзьевіча|	Вярлоў Віталій Генадзьевіч
Вярэніча Васіля Андрэевіча|	Вярэніч Васіль Андрэевіч
Гаеўскага Аляксандра Міхайлавіча|	Гаеўскі Аляксандр Міхайлавіч
Гайдука Аляксея Аляксеевіча|	Гайдук Аляксей Аляксеевіч
Галаўнёва Дзмітрыя Уладзіміравіча|	Галаўнёў Дзмітрый Уладзіміравіч
Галенку Сяргея Мікалаевіча|	Галенка Сяргей Мікалаевіч
Галубовіча Ігара Валянцінавіча|	Галубовіч Ігар Валянцінавіч
Галькевіча Аляксандра Фёдаравіча|	Галькевіч Аляксандр Фёдаравіч
Ганчара Сяргея Уладзіміравіча|	Ганчар Сяргей Уладзіміравіч
Ганчарова Юрыя Маркавіча|	Ганчароў Юрый Маркавіч
Ганчарука Сяргея Аляксандравіча|	Ганчарук Сяргей Аляксандравіч
Ганчарэнка Алену Генадзьеўну|	Ганчарэнка Алена Генадзьеўна
Гапановіча Яўгенія Сцяпанавіча|	Гапановіч Яўгеній Сцяпанавіч
Гарабюка Сяргея Віктаравіча|	Гарабюк Сяргей Віктаравіч
Гарадзецкага Уладзіміра Вітальевіча|	Гарадзецкі Уладзімір Вітальевіч
Гарбачэўскую Ірыну Уладзіміраўну|	Гарбачэўская Ірына Уладзіміраўна
Гарбунова Дзмітрыя Аляксандравіча|	Гарбуноў Дзмітрый Аляксандравіч
Гарбунова Паўла Уладзіміравіча|	Гарбуноў Павел Уладзіміравіч
Гарыновіч Вольгу Васільеўну|	Гарыновіч Вольга Васільеўна
Гаўрылава Андрэя Мікалаевіча|	Гаўрылаў Андрэй Мікалаевіч
Гацко Эдуарда Леанідавіча|	Гацко Эдуард Леанідавіч
Герасёву Алену Яўгеньеўну|	Герасёва Алена Яўгеньеўна
Гесця Сяргея Львовіча|	Гесць Сяргей Львовіч
Гецьманца Аляксандра Міхайлавіча|	Гецьманец Аляксандр Міхайлавіч
Гіля Уладзіміра Канстанцінавіча|	Гіль Уладзімір Канстанцінавіч
Гінько Аляксандра Віктаравіча|	Гінько Аляксандр Віктаравіч
Гогаля Станіслава Адамавіча|	Гогаль Станіслаў Адамавіч
Гольніка Ігара Васільевіча|	Гольнік Ігар Васільевіч
Готту Аляксандра Іванавіча|	Готта Аляксандр Іванавіч
Грамяшкевіча Ігара Станіслававіча|	Грамяшкевіч Ігар Станіслававіч
Громак Святлану Леанідаўну|	Громак Святлана Леанідаўна
Гружэўскага Андрэя Станіслававіча|	Гружэўскі Андрэй Станіслававіч
Грыб Святлану Віктараўну|	Грыб Святлана Віктараўна
Грыкіса Васіля Пятровіча|	Грыкіс Васіль Пятровіч
Грыца Андрэя Іванавіча|	Грыц Андрэй Іванавіч
Грыцаенку Андрэя Аляксандравіча|	Грыцаенка Андрэй Аляксандравіч
Грышана Паўла Авініравіча|	Грышан Павел Авініравіч
Грышана Сяргея Міхайлавіча|	Грышан Сяргей Міхайлавіч
Грышкевіча Сяргея Мікалаевіча|	Грышкевіч Сяргей Мікалаевіч
Грэцкага Сяргея Віктаравіча|	Грэцкі Сяргей Віктаравіч
Грэчкіна Віталія Алегавіча|	Грэчкін Віталій Алегавіч
Губскага Руслана Уладзіміравіча|	Губскі Руслан Уладзіміравіч
Гудзілова Дзмітрыя Пятровіча|	Гудзілоў Дзмітрый Пятровіч
Гульмантовіч Маргарыту Мікалаеўну|	Гульмантовіч Маргарыта Мікалаеўна
Гуля Аляксандра Міхайлавіча|	Гуль Аляксандр Міхайлавіч
Гурэцкую Святлану Канстанцінаўну|	Гурэцкая Святлана Канстанцінаўна
Гуткоўскага Сяргея Уладзіміравіча|	Гуткоўскі Сяргей Уладзіміравіч
Гуцера Юрыя Уладзіміравіча|	Гуцер Юрый Уладзіміравіч
Давідовіча Андрэя Аляксандравіча|	Давідовіч Андрэй Аляксандравіч
Давідовіча Вячаслава Віктаравіча|	Давідовіч Вячаслаў Віктаравіч
Дайліду Андрэя Мікалаевіча|	Дайліда Андрэй Мікалаевіч
Дакуку Дзяніса Анатольевіча|	Дакука Дзяніс Анатольевіч
Далганава Леаніда Іванавіча|	Далганаў Леанід Іванавіч
Далініна Андрэя Віктаравіча|	Далінін Андрэй Віктаравіч
Далінніка Дзмітрыя Аляксандравіча|	Даліннік Дзмітрый Аляксандравіч
Даніленку Аляксандра Міхайлавіча|	Даніленка Аляксандр Міхайлавіч
Данісевіча Віталя Мар’янавіча|	Данісевіч Віталь Мар’янавіч
Дараткевіча Юрыя Іванавіча|	Дараткевіч Юрый Іванавіч
Дашчынскую Наталлю Эдуардаўну|	Дашчынская Наталля Эдуардаўна
Дваранскага Ігара Міхайлавіча|	Дваранскі Ігар Міхайлавіч
Двужыльнага Віталя Мікалаевіча|	Двужыльны Віталь Мікалаевіч
Дзенісенку Генадзія Аляксандравіча|	Дзенісенка Генадзій Аляксандравіч
Дзергачова Аляксандра Аляксандравіча|	Дзергачоў Аляксандр Аляксандравіч
Дзермана Аляксандра Іванавіча|	Дзерман Аляксандр Іванавіч
Дзіву Андрэя Мікалаевіча|	Дзіва Андрэй Мікалаевіч
Дзікавіцкага Анатолія Георгіевіча|	Дзікавіцкі Анатолій Георгіевіч
Дзмітрук Вольгу Мікалаеўну|	Дзмітрук Вольга Мікалаеўна
Дзмітрука Віталія Мікалаевіча|	Дзмітрук Віталій Мікалаевіч
Дзядуля Антона Антонавіча|	Дзядуль Антон Антонавіч
Дзям’янава Уладзіміра Уладзіміравіча|	Дзям’янаў Уладзімір Уладзіміравіч
Дзям’яненку Віктара Іванавіча|	Дзям’яненка Віктар Іванавіч
Дзярагіну Святлану Васільеўну|	Дзярагіна Святлана Васільеўна
Дзятлаву Ірыну Міхайлаўну|	Дзятлава Ірына Міхайлаўна
Дораша Дзмітрыя Аляксандравіча|	Дораш Дзмітрый Аляксандравіч
Драздова Аляксандра Уладзіміравіча|	Драздоў Аляксандр Уладзіміравіч
Дрынь Валянціну Аляксандраўну|	Дрынь Валянціна Аляксандраўна
Дубіка Ігара Віктаравіча|	Дубік Ігар Віктаравіч
Дубінскага Мікалая Анатольевіча|	Дубінскі Мікалай Анатольевіч
Дубінца Аляксея Васільевіча|	Дубінец Аляксей Васільевіч
Дубовіка Міхаіла Юр’евіча|	Дубовік Міхаіл Юр’евіч
Дубовіка Юрыя Мікалаевіча|	Дубовік Юрый Мікалаевіч
Дубоўскага Сяргея Генадзьевіча|	Дубоўскі Сяргей Генадзьевіч
Дудаладава Аляксея Аляксеевіча|	Дудаладаў Аляксей Аляксеевіч
Дудко Віктара Антонавіча|	Дудко Віктар Антонавіч
Дыдышку Сяргея Канстанцінавіча|	Дыдышка Сяргей Канстанцінавіч
Емяльянава Ігара Віктаравіча|	Емяльянаў Ігар Віктаравіч
Ерашэнкава Яўгенія Сяргеевіча|	Ерашэнкаў Яўгеній Сяргеевіч
Еўсікава Паўла Уладзіміравіча|	Еўсікаў Павел Уладзіміравіч
Жалабкова Уладзіміра Уладзіміравіча|	Жалабкоў Уладзімір Уладзіміравіч
Жаўняка Віктара Рыгоравіча|	Жаўняк Віктар Рыгоравіч
Жук Зою Анатольеўну|	Жук Зоя Анатольеўна
Жука Андрэя Іванавіча|	Жук Андрэй Іванавіч
Жука Ігара Канстанцінавіча|	Жук Ігар Канстанцінавіч
Жука Сяргея Мікалаевіча|	Жук Сяргей Мікалаевіч
Жукоўскага Дзмітрыя Уладзіміравіча|	Жукоўскі Дзмітрый Уладзіміравіч
Жуселя Валерыя Уладзіслававіча|	Жусель Валерый Уладзіслававіч
Жывіцу Генадзія Францавіча|	Жывіца Генадзій Францавіч
Жыгара Максіма Дзмітрыевіча|	Жыгар Максім Дзмітрыевіч
Жыгарава Аляксея Валер’евіча|	Жыгараў Аляксей Валер’евіч
Жыгірэву Ганну Пятроўну|	Жыгірэва Ганна Пятроўна
Жыгунова Аляксея Уладзіміравіча|	Жыгуноў Аляксей Уладзіміравіч
Жыткоўскага Сяргея Вітальевіча|	Жыткоўскі Сяргей Вітальевіч
Жыхарку Фёдара Фёдаравіча|	Жыхарка Фёдар Фёдаравіч
Загорскага Мікалая Емяльянавіча|	Загорскі Мікалай Емяльянавіч
Зайцава Аляксандра Генадзьевіча|	Зайцаў Аляксандр Генадзьевіч
Зайцава Валерыя Мікалаевіча|	Зайцаў Валерый Мікалаевіч
Залатара Ігара Францавіча|	Залатар Ігар Францавіч
Занімонца Рыгора Рыгоравіча|	Занімонец Рыгор Рыгоравіч
Заноўскага Леаніда Фёдаравіча|	Заноўскі Леанід Фёдаравіч
Запечэнку Ігара Мікалаевіча|	Запечэнка Ігар Мікалаевіч
Зарубіцкую Валянціну Віктараўну|	Зарубіцкая Валянціна Віктараўна
Зарубу Аляксея Рыгоравіча|	Заруба Аляксей Рыгоравіч
Захарава Андрэя Валянцінавіча|	Захараў Андрэй Валянцінавіч
Захараву Ніну Васільеўну|	Захарава Ніна Васільеўна
Захвіцэвіча Аляксандра Аляксандравіча|	Захвіцэвіч Аляксандр Аляксандравіч
Зікрацьева Вячаслава Віктаравіча|	Зікрацьеў Вячаслаў Віктаравіч
Зінавенку Васілія Леанідавіча|	Зінавенка Васілій Леанідавіч
Зіноўева Ігара Уладзіміравіча|	Зіноўеў Ігар Уладзіміравіч
Зінчанку Уладзіміра Федаравіча|	Зінчанка Уладзімір Федаравіч
Змітрэвіча Юрыя Вацлававіча|	Змітрэвіч Юрый Вацлававіч
Зотава Вячаслава Генадзьевіча|	Зотаў Вячаслаў Генадзьевіч
Зубеля Руслана Віктаравіча|	Зубель Руслан Віктаравіч
Зуева Міхаіла Уладзіміравіча|	Зуеў Міхаіл Уладзіміравіч
Зязюлю Алега Пятровіча|	Зязюля Алег Пятровіч
Івановіча Аляксандра Генадзьевіча|	Івановіч Аляксандр Генадзьевіч
Іванчыка Аляксандра Раманавіча|	Іванчык Аляксандр Раманавіч
Іванчыкава Анатолія Васільевіча|	Іванчыкаў Анатолій Васільевіч
Івінскага Аляксандра Мікалаевіча|	Івінскі Аляксандр Мікалаевіч
Ігнатава Паўла Уладзіміравіча|	Ігнатаў Павел Уладзіміравіч
Ігнатовіча Аляксандра Іванавіча|	Ігнатовіч Аляксандр Іванавіч
Ільюка Сяргея Аляксандравіча|	Ільюк Сяргей Аляксандравіч
Ісаева Ігара Міхайлавіча|	Ісаеў Ігар Міхайлавіч
Ісакава Аляксея Вячаслававіча|	Ісакаў Аляксей Вячаслававіч
Кабака Андрэя Уладзіміравіча|	Кабак Андрэй Уладзіміравіч
Кабакова Юрыя Анатольевіча|	Кабакоў Юрый Анатольевіч
Кабілава Уктама Ібрагімавіча|	Кабілаў Уктам Ібрагімавіч
Кабяка Валерыя Віктаравіча|	Кабяк Валерый Віктаравіч
Каваленку Аляксандра Яўгеньевіча|	Каваленка Аляксандр Яўгеньевіч
Каваленку Андрэя Сяргеевіча|	Каваленка Андрэй Сяргеевіч
Каваленку Паўла Мікалаевіча|	Каваленка Павел Мікалаевіч
Кавалеўскага Дзмітрыя Аляксандравіча|	Кавалеўскі Дзмітрый Аляксандравіч
Кавалёва Аляксея Сямёнавіча|	Кавалёў Аляксей Сямёнавіч
Казлова Валерыя Пятровіча|	Казлоў Валерый Пятровіч
Казлова Руслана Віктаравіча|	Казлоў Руслан Віктаравіч
Казлова Сяргея Мікалаевіча|	Казлоў Сяргей Мікалаевіч
Казлова Яўгенія Паўлавіча|	Казлоў Яўгеній Паўлавіч
Казлоўскага Аляксандра Міхайлавіча|	Казлоўскі Аляксандр Міхайлавіч
Казлоўскага Дзмітрыя Аляксеевіча|	Казлоўскі Дзмітрый Аляксеевіч
Калацкага Вадзіма Аляксандравіча|	Калацкі Вадзім Аляксандравіч
Калача Валерыя Федаравіча|	Калач Валерый Федаравіч
Каліту Аляксея Іванавіча|	Каліта Аляксей Іванавіч
Каліха Паўла Мікалаевіча|	Каліх Павел Мікалаевіч
Калыбіну Алену Аркадзьеўну|	Калыбіна Алена Аркадзьеўна
Каляду Васілія Васільевіча|	Каляда Васілій Васільевіч
Камшакова Уладзіслава Аляксандравіча|	Камшакоў Уладзіслаў Аляксандравіч
Канавалава Яўгенія Віктаравіча|	Канавалаў Яўгеній Віктаравіч
Канаваліка Віталія Міхайлавіча|	Канавалік Віталій Міхайлавіч
Канановіч Наталлю Аляксандраўну|	Канановіч Наталля Аляксандраўна
Канановіча Вячаслава Генадзьевіча|	Канановіч Вячаслаў Генадзьевіч
Канапельку Алега Мікалаевіча|	Канапелька Алег Мікалаевіч
Кандзіранду Фёдара Міхайлавіча|	Кандзіранда Фёдар Міхайлавіч
Кандраценю Аксану Мікалаеўну|	Кандраценя Аксана Мікалаеўна
Кандрацёнка Васіля Анатольевіча|	Кандрацёнак Васіль Анатольевіч
Кандрацкую Надзею Мікалаеўну|	Кандрацкая Надзея Мікалаеўна
Канторшчыкава Аляксандра Аляксандравіча|	Канторшчыкаў Аляксандр Аляксандравіч
Капітонава Уладзіміра Мікалаевіча|	Капітонаў Уладзімір Мікалаевіч
Капорыкава Андрэя Міхайлавіча|	Капорыкаў Андрэй Міхайлавіч
Капусціна Аляксандра Мікалаевіча|	Капусцін Аляксандр Мікалаевіч
Капусціна Дзмітрыя Аляксеевіча|	Капусцін Дзмітрый Аляксеевіч
Капчука Андрэя Аляксеевіча|	Капчук Андрэй Аляксеевіч
Каралькову Лілію Леанідаўну|	Каралькова Лілія Леанідаўна
Караля Юрыя Пятровіча|	Караль Юрый Пятровіч
Карасікава Вячаслава Віктаравіча|	Карасікаў Вячаслаў Віктаравіч
Каржа Аляксандра Васільевіча|	Карж Аляксандр Васільевіч
Карнейчыка Дзмітрыя Валер’евіча|	Карнейчык Дзмітрый Валер’евіч
Карпенку Уладзіміра Міхайлавіча|	Карпенка Уладзімір Міхайлавіч
Карповіча Дзмітрыя Яўгеньевіча|	Карповіч Дзмітрый Яўгеньевіч
Карсака Андрэя Міхайлавіча|	Карсак Андрэй Міхайлавіч
Касарэвіча Анатолія Паўлавіча|	Касарэвіч Анатолій Паўлавіч
Касаціка Аляксандра Эдуардавіча|	Касацік Аляксандр Эдуардавіч
Касінскага Сяргея Уладзіміравіча|	Касінскі Сяргей Уладзіміравіч
Касцючэнку Валерыя Сяргеевіча|	Касцючэнка Валерый Сяргеевіч
Катка Уладзіміра Станіслававіча|	Катк Уладзімір Станіслававіч
Качаенку Віктара Васільевіча|	Качаенка Віктар Васільевіч
Качанава Анатоля Леанідавіча|	Качанаў Анатоль Леанідавіч
Качаргіна Паўла Валер’евіча|	Качаргін Павел Валер’евіч
Качкана Аляксандра Міхайлавіча|	Качкан Аляксандр Міхайлавіч
Каштанаву Таццяну Генадзьеўну|	Каштанава Таццяна Генадзьеўна
Керэль Наталлю Сайфіханаўну|	Керэль Наталля Сайфіханаўна
Кіркіжа Юрыя Анатольевіча|	Кіркіж Юрый Анатольевіч
Кірэя Васілія Мікалаевіча|	Кірэй Васілій Мікалаевіч
Кісялёва Сяргея Мікалаевіча|	Кісялёў Сяргей Мікалаевіч
Кісяля Вадзіма Міхайлавіча|	Кісяль Вадзім Міхайлавіч
Кішчыц Валянціну Міхайлаўну|	Кішчыц Валянціна Міхайлаўна
Клімава Аляксандра Васільевіча|	Клімаў Аляксандр Васільевіч
Клімава Максіма Юр’евіча|	Клімаў Максім Юр’евіч
Клімашэвіча Аляксея Васільевіча|	Клімашэвіч Аляксей Васільевіч
Клімковіч Жанну Мікалаеўну|	Клімковіч Жанна Мікалаеўна
Клімовіча Уладзіміра Сяргеевіча|	Клімовіч Уладзімір Сяргеевіч
Клімчука Віталія Мікалаевіча|	Клімчук Віталій Мікалаевіч
Клопава Сяргея Яфімавіча|	Клопаў Сяргей Яфімавіч
Кляпацкага Алега Іосіфавіча|	Кляпацкі Алег Іосіфавіч
Кляўцова Аляксея Міхайлавіча|	Кляўцоў Аляксей Міхайлавіч
Кобрына Аляксандра Іванавіча|	Кобрын Аляксандр Іванавіч
Кобца Аляксандра Барысавіча|	Кобц Аляксандр Барысавіч
Козела Валерыя Леанідавіча|	Козел Валерый Леанідавіч
Козіч Марыну Іванаўну|	Козіч Марына Іванаўна
Комлача Юрыя Іванавіча|	Комлач Юрый Іванавіч
Конанава Аляксандра Мікалаевіча|	Конанаў Аляксандр Мікалаевіч
Кострыкаву Раісу Іванаўну|	Кострыкава Раіса Іванаўна
Коўзіка Руслана Васільевіча|	Коўзік Руслан Васільевіч
Кошыля Вадзіма Васільевіча|	Кошыль Вадзім Васільевіч
Крангольда Сяргея Леанідавіча|	Крангольд Сяргей Леанідавіч
Красоўскага Сяргея Валянцінавіча|	Красоўскі Сяргей Валянцінавіч
Крата Вадзіма Іванавіча|	Крат Вадзім Іванавіч
Краўцэвіча Івана Станіслававіча|	Краўцэвіч Іван Станіслававіч
Краўчанку Андрэя Уладзіміравіча|	Краўчанка Андрэй Уладзіміравіч
Круглова Аляксея Віктаравіча|	Круглоў Аляксей Віктаравіч
Крывалапа Уладзіміра Уладзіміравіча|	Крывалап Уладзімір Уладзіміравіч
Крывіцкага Аляксея Вячаслававіча|	Крывіцкі Аляксей Вячаслававіч
Крывялёва Мікалая Аляксандравіча|	Крывялёў Мікалай Аляксандравіч
Крэйдзіча Аляксандра Андрэевіча|	Крэйдзіч Аляксандр Андрэевіч
Кудашкіну Ірыну Аляксандраўну|	Кудашкіна Ірына Аляксандраўна
Кудзінаву Наталлю Валянцінаўну|	Кудзінава Наталля Валянцінаўна
Кузьмінскага Віктара Станіслававіча|	Кузьмінскі Віктар Станіслававіч
Кузьмінца Паўла Віктаравіча|	Кузьмінец Павел Віктаравіч
Кукобнікава Віталія Віктаравіча|	Кукобнікаў Віталій Віктаравіч
Кукшынава Вадзіма Рыгоравіча|	Кукшынаў Вадзім Рыгоравіч
Кулак Галіну Вінцаўну|	Кулак Галіна Вінцаўна
Куліка Дзмітрыя Леанідавіча|	Кулік Дзмітрый Леанідавіч
Кулініча Віталія Рыгоравіча|	Кулініч Віталій Рыгоравіч
Кульчыцкага Генадзія Уладзіміравіча|	Кульчыцкі Генадзій Уладзіміравіч
Куневіча Уладзіміра Уладзіміравіча|	Куневіч Уладзімір Уладзіміравіч
Купрыяненку Аляксандра Віктаравіча|	Купрыяненка Аляксандр Віктаравіч
Курапея Аляксандра Мікалаевіча|	Курапей Аляксандр Мікалаевіч
Курбатава Аляксея Мікалаевіча|	Курбатаў Аляксей Мікалаевіч
Кургана Аляксандра Міхайлавіча|	Курган Аляксандр Міхайлавіч
Курлова Рамана Аляксандравіча|	Курлоў Раман Аляксандравіч
Кутырова Аляксандра Сяргеевіча|	Кутыроў Аляксандр Сяргеевіч
Кухальскага Валерыя Зянонавіча|	Кухальскі Валерый Зянонавіч
Кучко Аляксандра Пятровіча|	Кучко Аляксандр Пятровіч
Лабанок Таццяну Валер’еўну|	Лабанок Таццяна Валер’еўна
Лабаска Яўгенія Іванавіча|	Лабаск Яўгеній Іванавіч
Лавіцкага Дзмітрыя Мікалаевіча|	Лавіцкі Дзмітрый Мікалаевіч
Лазіцкага Леаніда Іванавіча|	Лазіцкі Леанід Іванавіч
Лапеку Алега Ігаравіча|	Лапека Алег Ігаравіч
Ларына Андрэя Віктаравіча|	Ларын Андрэй Віктаравіч
Ласевіча Дзмітрыя Аляксандравіча|	Ласевіч Дзмітрый Аляксандравіч
Латышава Сяргея Віталевіча|	Латышаў Сяргей Віталевіч
Латышаву Святлану Яўгеньеўну|	Латышава Святлана Яўгеньеўна
Лаўнікава Уладзіміра Уладзіміравіча|	Лаўнікаў Уладзімір Уладзіміравіч
Лаўрэцкую Вольгу Рыгораўну|	Лаўрэцкая Вольга Рыгораўна
Лаўскага Вячаслава Усеваладавіча|	Лаўскі Вячаслаў Усеваладавіч
Лебядзько Валянціну Уладзіміраўну|	Лебядзько Валянціна Уладзіміраўна
Левашэню Аляксандра Аляксеевіча|	Левашэня Аляксандр Аляксеевіч
Леўчука Андрэя Сцяпанавіча|	Леўчук Андрэй Сцяпанавіч
Ліна Віталія Мікалаевіча|	Лін Віталій Мікалаевіч
Ліпскага Сяргея Пятровіча|	Ліпскі Сяргей Пятровіч
Ліса Аляксандра Аляксандравіча|	Ліс Аляксандр Аляксандравіч
Лісавец Святлану Раманаўну|	Лісавец Святлана Раманаўна
Лісаковіча Сяргея Мікалаевіча|	Лісаковіч Сяргей Мікалаевіч
Лісіцкага Сяргея Адамавіча|	Лісіцкі Сяргей Адамавіч
Лісіцкага Сяргея Аляксандравіча|	Лісіцкі Сяргей Аляксандравіч
Ліска Анатолія Анатольевіча|	Ліск Анатолій Анатольевіч
Лосева Сяргея Віктаравіча|	Лосеў Сяргей Віктаравіч
Лосіка Аляксандра Уладзіміравіча|	Лосік Аляксандр Уладзіміравіч
Лукшу Аляксандра Іванавіча|	Лукша Аляксандр Іванавіч
Лук’яновіча Анатоля Леанідавіча|	Лук’яновіч Анатоль Леанідавіч
Лупандзіна Дзмітрыя Яўгеньевіча|	Лупандзін Дзмітрый Яўгеньевіч
Луцаева Андрэя Міхайлавіча|	Луцаеў Андрэй Міхайлавіч
Луцкевіча Юрыя Іванавіча|	Луцкевіч Юрый Іванавіч
Любіна Паўла Валер’евіча|	Любін Павел Валер’евіч
Люхту Алега Уладзіміравіча|	Люхта Алег Уладзіміравіч
Лявончыка Аляксандра Уладзіміравіча|	Лявончык Аляксандр Уладзіміравіч
Ляпеху Дзмітрыя Мікалаевіча|	Ляпеха Дзмітрый Мікалаевіч
Лятучаву Вікторыю Уладзіміраўну|	Лятучава Вікторыя Уладзіміраўна
Ляўко Наталлю Уладзіміраўну|	Ляўко Наталля Уладзіміраўна
Ляха Уладзіміра Фёдаравіча|	Лях Уладзімір Фёдаравіч
Ляхоўскага Віктара Іванавіча|	Ляхоўскі Віктар Іванавіч
Ляшкевіча Міхаіла Мікалаевіча|	Ляшкевіч Міхаіл Мікалаевіч
Ляшчанку Андрэя Пятровіча|	Ляшчанка Андрэй Пятровіч
Мазура Паўла Паўлавіча|	Мазур Павел Паўлавіч
Мазурэнку Максіма Валер’евіча|	Мазурэнка Максім Валер’евіч
Маісеева Станіслава Аляксандравіча|	Маісееў Станіслаў Аляксандравіч
Макараву Ірыну Генадзьеўну|	Макарава Ірына Генадзьеўна
Макаранка Таццяну Сяргееўну|	Макаранка Таццяна Сяргееўна
Макарэвіча Мікалая Мікалаевіча|	Макарэвіч Мікалай Мікалаевіч
Максіменку Станіслава Васільевіча|	Максіменка Станіслаў Васільевіч
Максімовіча Часлава Іванавіча|	Максімовіч Часлаў Іванавіч
Малага Вадзіма Аляксандравіча|	Малы Вадзім Аляксандравіч
Мальцэвіча Віталія Іванавіча|	Мальцэвіч Віталій Іванавіч
Маргачова Паўла Часлававіча|	Маргачоў Павел Часлававіч
Мармыша Аляксандра Уладзіміравіча|	Мармыш Аляксандр Уладзіміравіч
Марозава Дзмітрыя Васільевіча|	Марозаў Дзмітрый Васільевіч
Марусава Мікалая Мікалаевіча|	Марусаў Мікалай Мікалаевіч
Марчанка Таццяну Іванаўну|	Марчанка Таццяна Іванаўна
Марэева Канстанціна Яўгенавіча|	Марэеў Канстанцін Яўгенавіч
Масквічову Лілю Іванаўну|	Масквічова Ліля Іванаўна
Маслава Юрыя Аляксандравіча|	Маслаў Юрый Аляксандравіч
Масюля Анатолія Часлававіча|	Масюль Анатолій Часлававіч
Матукевіча Віктара Станіслававіча|	Матукевіч Віктар Станіслававіч
Матылевіча Віталія Мікалаевіча|	Матылевіч Віталій Мікалаевіч
Мацкевіча Валерыя Вацлававіча|	Мацкевіч Валерый Вацлававіч
Мецько Яўгенія Аляксандравіча|	Мецько Яўгеній Аляксандравіч
Мініча Андрэя Іванавіча|	Мініч Андрэй Іванавіч
Мінько Аляксандра Уладзіміравіча|	Мінько Аляксандр Уладзіміравіч
Міранкова Аляксандра Васільевіча|	Міранкоў Аляксандр Васільевіч
Мірошнікава Васілія Аляксандравіча|	Мірошнікаў Васілій Аляксандравіч
Місюру Ігара Андрэевіча|	Місюра Ігар Андрэевіч
Міхальчанку Андрэя Валер’евіча|	Міхальчанка Андрэй Валер’евіч
Мішко Сяргея Аляксеевіча|	Мішко Сяргей Аляксеевіч
Мішко Юрыя Мітрафанавіча|	Мішко Юрый Мітрафанавіч
Молаша Аляксандра Мікалаевіча|	Молаш Аляксандр Мікалаевіч
Мухортых Валянціну Аляксандраўну|	Мухортых Валянціна Аляксандраўна
Мысліцкага Дзмітрыя Віктаравіча|	Мысліцкі Дзмітрый Віктаравіч
Мядзельца Віталія Міхайлавіча|	Мядзельц Віталій Міхайлавіч
Мясніковіча Віктара Дзянісавіча|	Мясніковіч Віктар Дзянісавіч
Мяцечку Сяргея Мікалаевіча|	Мяцечка Сяргей Мікалаевіч
Мяшкова Данілу Віктаравіча|	Мяшкоў Даніла Віктаравіч
Навалаева Ігара Мікалаевіча|	Навалаеў Ігар Мікалаевіч
Навіцкага Уладзіміра Вячаслававіча|	Навіцкі Уладзімір Вячаслававіч
Навуменку Івана Уладзіміравіча|	Навуменка Іван Уладзіміравіч
Навуменку Ігара Мікалаевіча|	Навуменка Ігар Мікалаевіч
Нагавіцыну Валянціну Чаславаўну|	Нагавіцына Валянціна Чаславаўна
Надтачаева Віктара Віктаравіча|	Надтачаеў Віктар Віктаравіч
Наскавец Людмілу Фёдараўну|	Наскавец Людміла Фёдараўна
Наумовіча Алега Уладзіміравіча|	Наумовіч Алег Уладзіміравіч
Невядомскую Людмілу Яўгеньеўну|	Невядомская Людміла Яўгеньеўна
Непачаловіч Людмілу Васільеўну|	Непачаловіч Людміла Васільеўна
Несцярэнку Сяргея Ігаравіча|	Несцярэнка Сяргей Ігаравіч
Неўмяржыцкага Сяргея Канстанцінавіча|	Неўмяржыцкі Сяргей Канстанцінавіч
Нешко Віталія Вітальевіча|	Нешко Віталій Вітальевіч
Нікалаева Уладзіміра Анатольевіча|	Нікалаеў Уладзімір Анатольевіч
Нікалаюка Пятра Пятровіча|	Нікалаюк Пётр Пятровіч
Нікітку Генадзя Міхайлавіча|	Нікітка Генадзь Міхайлавіч
Нікіценку Вячаслава Алегавіча|	Нікіценка Вячаслаў Алегавіч
Нішта Аляксандра Рыгоравіча|	Нішт Аляксандр Рыгоравіч
Новака Андрэя Аляксандравіча|	Новак Андрэй Аляксандравіч
Новіка Аляксандра Іванавіча|	Новік Аляксандр Іванавіч
Новікава Віктара Пятровіча|	Новікаў Віктар Пятровіч
Новікава Віталія Віктаравіча|	Новікаў Віталій Віктаравіч
Нужную Ірыну Уладзіміраўну|	Нужная Ірына Уладзіміраўна
Няратава Арцема Аляксандравіча|	Няратаў Арцем Аляксандравіч
Нячая Ігара Юр’евіча|	Нячай Ігар Юр’евіч
Осіпава Дзяніса Мікалаевіча|	Осіпаў Дзяніс Мікалаевіч
Осіпава Міхаіла Віктаравіча|	Осіпаў Міхаіл Віктаравіч
Палаўчэню Аляксандра Канстанцінавіча|	Палаўчэня Аляксандр Канстанцінавіч
Палубінскага Аляксандра Васільевіча|	Палубінскі Аляксандр Васільевіч
Палякова Андрэя Уладзіміравіча|	Палякоў Андрэй Уладзіміравіч
Пападзько Дзяніса Уладзіміравіча|	Пападзько Дзяніс Уладзіміравіч
Папко Аляксандра Аляксандравіча|	Папко Аляксандр Аляксандравіч
Папкову Ірыну Канстанцінаўну|	Папкова Ірына Канстанцінаўна
Папляўко Генадзія Васільевіча|	Папляўко Генадзій Васільевіч
Папругу Алену Віктараўну|	Папруга Алена Віктараўна
Парфененку Юрыя Анатольевіча|	Парфененка Юрый Анатольевіч
Пархомчыка Сяргея Іванавіча|	Пархомчык Сяргей Іванавіч
Парышкуру Максіма Анатольевіча|	Парышкура Максім Анатольевіч
Пасікава Дзмітрыя Леанідавіча|	Пасікаў Дзмітрый Леанідавіч
Паско Сяргея Міраслававіча|	Паско Сяргей Міраслававіч
Патапчука Мікалая Васільевіча|	Патапчук Мікалай Васільевіч
Паўлава Аляксандра Леанідавіча|	Паўлаў Аляксандр Леанідавіч
Паўловіча Аляксандра Мікалаевіча|	Паўловіч Аляксандр Мікалаевіч
Пацая Дзмітрыя Іванавіча|	Пацай Дзмітрый Іванавіч
Пачыкету Мікалая Васільевіча|	Пачыкета Мікалай Васільевіч
Пейгановіча Юрыя Міхайлавіча|	Пейгановіч Юрый Міхайлавіч
Пенкрата Аляксандра Мікалаевіча|	Пенкрат Аляксандр Мікалаевіч
Перапецкага Аляксандра Міхайлавіча|	Перапецкі Аляксандр Міхайлавіч
Петушок Святлану Вячаславаўну|	Петушок Святлана Вячаславаўна
Пехава Аляксандра Валер’евіча|	Пехаў Аляксандр Валер’евіч
Пікузу Руслана Русланавіча|	Пікуза Руслан Русланавіч
Пінчукова Андрэя Усеваладавіча|	Пінчукоў Андрэй Усеваладавіч
Пісарыка Андрэя Мікалаевіча|	Пісарык Андрэй Мікалаевіч
Плахотніка Міхаіла Аляксеевіча|	Плахотнік Міхаіл Аляксеевіч
Плюцінскага Ігара Уладзіміравіча|	Плюцінскі Ігар Уладзіміравіч
Поніка Юрыя Анатольявіча|	Понік Юрый Анатольявіч
Пракапюка Станіслава Станіслававіча|	Пракапюк Станіслаў Станіслававіч
Прановіча Аляксандра Васільевіча|	Прановіч Аляксандр Васільевіч
Пратасенка Раісу Пятроўну|	Пратасенка Раіса Пятроўна
Прахарэнку Аляксандра Леанідавіча|	Прахарэнка Аляксандр Леанідавіч
Прачуханава Уладзіслава Міхайлавіча|	Прачуханаў Уладзіслаў Міхайлавіч
Протаса Паўла Іванавіча|	Протас Павел Іванавіч
Прохарава Рамана Віктаравіча|	Прохараў Раман Віктаравіч
Прышчэп Ірыну Анатольеўну|	Прышчэп Ірына Анатольеўна
Пугача Васіля Рыгоравіча|	Пугач Васіль Рыгоравіч
Пукалу Дзмітрыя Сяргеевіча|	Пукала Дзмітрый Сяргеевіч
Пунчанку Васілія Уладзіміравіча|	Пунчанка Васілій Уладзіміравіч
Пунько Андрэя Іванавіча|	Пунько Андрэй Іванавіч
Пусташылу Андрэя Якаўлевіча|	Пусташыла Андрэй Якаўлевіч
Пусько Пятра Мікалаевіча|	Пусько Пётр Мікалаевіч
Рабцава Алега Аляксандравіча|	Рабцаў Алег Аляксандравіч
Рагажынскага Аляксандра Віктаравіча|	Рагажынскі Аляксандр Віктаравіч
Радзюка Аляксандра Мікалаевіча|	Радзюк Аляксандр Мікалаевіч
Радзюка Валерыя Уладзіміравіча|	Радзюк Валерый Уладзіміравіч
Ракіту Ігара Анатольевіча|	Ракіта Ігар Анатольевіч
Раковіча Аляксея Валер’евіча|	Раковіч Аляксей Валер’евіч
Раманюка Цімафея Васільевіча|	Раманюк Цімафей Васільевіч
Раску Дзмітрыя Дзмітрыевіча|	Раска Дзмітрый Дзмітрыевіч
Рацкевіча Віктара Яўгеньевіча|	Рацкевіч Віктар Яўгеньевіч
Рогатнева Валерыя Валер’евіча|	Рогатнеў Валерый Валер’евіч
Родзевіча Дзмітрыя Зыгмундавіча|	Родзевіч Дзмітрый Зыгмундавіч
Рончыка Віктара Анатольевіча|	Рончык Віктар Анатольевіч
Рошчыну Алесю Іванаўну|	Рошчына Алеся Іванаўна
Рубіса Ігара Васільевіча|	Рубіс Ігар Васільевіч
Рудазуба Віталія Георгіевіча|	Рудазуб Віталій Георгіевіч
Рудовіча Юрыя Станіслававіча|	Рудовіч Юрый Станіслававіч
Руца Міхаіла Мікалаевіча|	Руц Міхаіл Мікалаевіч
Рыбака Алега Адамавіча|	Рыбак Алег Адамавіч
Рыбачонка Мікалая Іванавіча|	Рыбачонак Мікалай Іванавіч
Рэвінскага Аляксандра Аляксандравіча|	Рэвінскі Аляксандр Аляксандравіч
Рэйшэля Станіслава Станіслававіча|	Рэйшэль Станіслаў Станіслававіч
Сабалеўскую Святлану Міфодзьеўну|	Сабалеўская Святлана Міфодзьеўна
Савіна Анатолія Анатольевіча|	Савін Анатолій Анатольевіч
Савіцкага Вячаслава Мікалаевіча|	Савіцкі Вячаслаў Мікалаевіч
Савіцкага Дзмітрыя Уладзіміравіча|	Савіцкі Дзмітрый Уладзіміравіч
Савосіка Аляксандра Леанідавіча|	Савосік Аляксандр Леанідавіч
Савянка Дзмітрыя Віктаравіча|	Савянок Дзмітрый Віктаравіч
Савянкова Паўла Іванавіча|	Савянкоў Павел Іванавіч
Сазонава Міхаіла Генадзьевіча|	Сазонаў Міхаіл Генадзьевіч
Сакалоўскага Івана Юр’евіча|	Сакалоўскі Іван Юр’евіч
Сакаўца Віталя Уладзіміравіча|	Сакавец Віталь Уладзіміравіч
Саладуха Таццяну Сяргееўну|	Саладуха Таццяна Сяргееўна
Салама Дануту Генрыхаўну|	Салама Данута Генрыхаўна
Сальву Андрэя Канстанцінавіча|	Сальва Андрэй Канстанцінавіч
Самахвалава Міхаіла Купрыянавіча|	Самахвалаў Міхаіл Купрыянавіч
Сапегу Дзмітрыя Анатольевіча|	Сапега Дзмітрый Анатольевіч
Сапона Анатолія Лявонцьевіча|	Сапон Анатолій Лявонцьевіч
Саскаўца Сяргея Міхайлавіча|	Саскавец Сяргей Міхайлавіч
Сахарука Дзмітрыя Аляксандравіча|	Сахарук Дзмітрый Аляксандравіч
Свідзінскага Руслана Уладзіміравіча|	Свідзінскі Руслан Уладзіміравіч
Свістунова Міхаіла Мікалаевіча|	Свістуноў Міхаіл Мікалаевіч
Свістунова Уладзіміра Пятровіча|	Свістуноў Уладзімір Пятровіч
Селівёрстава Аляксея Валянцінавіча|	Селівёрстаў Аляксей Валянцінавіч
Сеня Уладзіміра Аляксандравіча|	Сень Уладзімір Аляксандравіч
Серафімовіча Ігара Віктаравіча|	Серафімовіч Ігар Віктаравіч
Сергеля Аляксандра Леанідавіча|	Сергель Аляксандр Леанідавіч
Сівіцкую Галіну Генрыхаўну|	Сівіцкая Галіна Генрыхаўна
Сідарава Віктара Віктаравіча|	Сідараў Віктар Віктаравіч
Сідаровіча Сяргея Ананьевіча|	Сідаровіч Сяргей Ананьевіч
Сідарэнка Алену Валер’еўну|	Сідарэнка Алена Валер’еўна
Сіду Уладзіміра Уладзіміравіча|	Сіда Уладзімір Уладзіміравіч
Сілівончыка Андрэя Андрэевіча|	Сілівончык Андрэй Андрэевіч
Сіліча Дзмітрыя Канстанцінавіча|	Сіліч Дзмітрый Канстанцінавіч
Сіўчака Васілія Дзмітрыевіча|	Сіўчак Васілій Дзмітрыевіч
Скадорву Алега Іванавіча|	Скадорва Алег Іванавіч
Скалубу Уладзіміра Пятровіча|	Скалуба Уладзімір Пятровіч
Скіруху Андрэя Пятровіча|	Скіруха Андрэй Пятровіч
Скокава Станіслава Віктаравіча|	Скокаў Станіслаў Віктаравіч
Скробата Дзмітрыя Іосіфавіча|	Скробат Дзмітрый Іосіфавіч
Скрундзя Ігара Ірэнавушавіча|	Скрундзь Ігар Ірэнавушавіч
Слізеня Сяргея Уладзіміравіча|	Слізень Сяргей Уладзіміравіч
Слушко Івана Іванавіча|	Слушко Іван Іванавіч
Собалева Аляксандра Уладзіміравіча|	Собалеў Аляксандр Уладзіміравіч
Собіна Андрэя Міхайлавіча|	Собін Андрэй Міхайлавіч
Солтана Сяргея Эдмундавіча|	Солтан Сяргей Эдмундавіч
Ступакевіча Аляксандра Іванавіча|	Ступакевіч Аляксандр Іванавіч
Стэльмана Юрыя Вітальевіча|	Стэльман Юрый Вітальевіч
Супрунчука Дзмітрыя Мікалаевіча|	Супрунчук Дзмітрый Мікалаевіч
Сцепанца Аляксея Віктаравіча|	Сцепанец Аляксей Віктаравіч
Сцефановіч Ірыну Міхайлаўну|	Сцефановіч Ірына Міхайлаўна
Сцефановіча Валерыя Вацлававіча|	Сцефановіч Валерый Вацлававіч
Сцяпанчанку Дзмітрыя Уладзіміравіча|	Сцяпанчанка Дзмітрый Уладзіміравіч
Сцяцурына Алега Віктаравіча|	Сцяцурын Алег Віктаравіч
Сыча Івана Стахавіча|	Сыч Іван Стахавіч
Сярэдзіча Сяргея Казіміравіча|	Сярэдзіч Сяргей Казіміравіч
Талайку Валерыя Аляксеевіча|	Талайка Валерый Аляксеевіч
Талатая Сяргея Валер’евіча|	Талатай Сяргей Валер’евіч
Тарасевіча Юрыя Георгіевіча|	Тарасевіч Юрый Георгіевіч
Тарасенко Алену Віктараўну|	Тарасенко Алена Віктараўна
Тарасенку Уладзіміра Анатольевіча|	Тарасенка Уладзімір Анатольевіч
Тарашкевіча Максіма Сцяпанавіча|	Тарашкевіч Максім Сцяпанавіч
Тарлецкага Дзмітрыя Мікалаевіча|	Тарлецкі Дзмітрый Мікалаевіч
Трошку Сяргея Аляксандравіча|	Трошка Сяргей Аляксандравіч
Трубача Сяргея Генадзьевіча|	Трубач Сяргей Генадзьевіч
Трухана Аляксея Пятровіча|	Трухан Аляксей Пятровіч
Трухана Міхаіла Пятровіча|	Трухан Міхаіл Пятровіч
Трыпузаву Антаніну Антонаўну|	Трыпузава Антаніна Антонаўна
Туркевіча Васілія Канстанцінавіча|	Туркевіч Васілій Канстанцінавіч
Турло Сяргея Юльянавіча|	Турло Сяргей Юльянавіч
Туцкага Ігара Ігаравіча|	Туцкі Ігар Ігаравіч
Тылецкага Аляксея Уладзіміравіча|	Тылецкі Аляксей Уладзіміравіч
Украінца Ігара Уладзіміравіча|	Украінец Ігар Уладзіміравіч
Уласовіч Алену Уладзіміраўну|	Уласовіч Алена Уладзіміраўна
Урбановіча Тадэвуша Юзэфавіча|	Урбановіч Тадэвуш Юзэфавіч
Ушоліка Паўла Міхайлавіча|	Ушолік Павел Міхайлавіч
Уюнаўца Андрэя Міхайлавіча|	Уюнавец Андрэй Міхайлавіч
Фаміна Аляксея Вячаслававіча|	Фамін Аляксей Вячаслававіч
Федаровіча Ігара Уладзіміравіча|	Федаровіч Ігар Уладзіміравіч
Федчанку Сяргея Васільевіча|	Федчанка Сяргей Васільевіч
Фесіна Андрэя Уладзіміравіча|	Фесін Андрэй Уладзіміравіч
Філёва Аляксея Валер’евіча|	Філёў Аляксей Валер’евіч
Філіновіча Дзмітрыя Васільевіча|	Філіновіч Дзмітрый Васільевіч
Філіпенку Аляксандра Васільевіча|	Філіпенка Аляксандр Васільевіч
Фядковіча Уладзіміра Іванавіча|	Фядковіч Уладзімір Іванавіч
Фядосенку Сяргея Васільевіча|	Фядосенка Сяргей Васільевіч
Фядосіка Уладзіміра Мікалаевіча|	Фядосік Уладзімір Мікалаевіч
Халянкова Сяргея Мікалаевіча|	Халянкоў Сяргей Мікалаевіч
Харланчука Міхаіла Уладзіміравіча|	Харланчук Міхаіл Уладзіміравіч
Харусь Святлану Валянцінаўну|	Харусь Святлана Валянцінаўна
Харыбіна Грыгорыя Віктаравіча|	Харыбін Грыгорый Віктаравіч
Хацяна Анатолія Іосіфавіча|	Хацян Анатолій Іосіфавіч
Хітро Вольгу Сяргееўну|	Хітро Вольга Сяргееўна
Хлябцэвіча Уладзіміра Збігневіча|	Хлябцэвіч Уладзімір Збігневіч
Хмарука Паўла Паўлавіча|	Хмарук Павел Паўлавіч
Хмялеўскую Таццяну Аляксандраўну|	Хмялеўская Таццяна Аляксандраўна
Хонскага Сяргея Аляксандравіча|	Хонскі Сяргей Аляксандравіч
Хрокалава Віталія Аляксандравіча|	Хрокалаў Віталій Аляксандравіч
Цапоту Міхаіла Мікалаевіча|	Цапота Міхаіл Мікалаевіч
Цаюна Дзмітрыя Радзіслававіча|	Цаюн Дзмітрый Радзіслававіч
Цвяцінскага Аляксандра Анатольевіча|	Цвяцінскі Аляксандр Анатольевіч
Цвяцінскага Сяргея Васільевіча|	Цвяцінскі Сяргей Васільевіч
Цімашэнку Андрэя Уладзіміравіча|	Цімашэнка Андрэй Уладзіміравіч
Цімашэнку Дзмітрыя Пятровіча|	Цімашэнка Дзмітрый Пятровіч
Ціхана Івана Рыгоравіча|	Ціхан Іван Рыгоравіч
Цішкевіч Таццяну Васільеўну|	Цішкевіч Таццяна Васільеўна
Цмыга Андрэя Уладзіміравіча|	Цмыг Андрэй Уладзіміравіч
Цога Аляксандра Валянцінавіча|	Цог Аляксандр Валянцінавіч
Цыганава Міхаіла Уладзіміравіча|	Цыганаў Міхаіл Уладзіміравіч
Цырульнікава Яфіма Леанідавіча|	Цырульнікаў Яфім Леанідавіч
Цюева Даніла Пятровіча|	Цюеў Даніл Пятровіч
Чалевіча Вячаслава Віктаравіча|	Чалевіч Вячаслаў Віктаравіч
Чапялінскага Юрыя Пятровіча|	Чапялінскі Юрый Пятровіч
Чараховіч Марыю Сяргееўну|	Чараховіч Марыя Сяргееўна
Чарнецкага Аляксандра Мікалаевіча|	Чарнецкі Аляксандр Мікалаевіч
Чарняк Святлану Валянцінаўну|	Чарняк Святлана Валянцінаўна
Чарняўскага Міхаіла Генадзьевіча|	Чарняўскі Міхаіл Генадзьевіч
Чміля Андрэя Анатольевіча|	Чміль Андрэй Анатольевіч
Чоса Аляксандра Валер’евіча|	Чос Аляксандр Валер’евіч
Чугунова Алега Уладзіміравіча|	Чугуноў Алег Уладзіміравіч
Чудава Мікалая Аляксандравіча|	Чудаў Мікалай Аляксандравіч
Чуйко Аляксандра Канстанцінавіча|	Чуйко Аляксандр Канстанцінавіч
Чэбушава Дзмітрыя Іванавіча|	Чэбушаў Дзмітрый Іванавіч
Чэляеўскага Міхаіла Міхайлавіча|	Чэляеўскі Міхаіл Міхайлавіч
Чэркаса Дзмітрыя Станіслававіча|	Чэркас Дзмітрый Станіслававіч
Шабанава Канстанціна Віктаравіча|	Шабанаў Канстанцін Віктаравіч
Шабуню Віталія Эдуардавіча|	Шабуня Віталій Эдуардавіч
Шавеля Юрыя Іванавіча|	Шавель Юрый Іванавіч
Шархуна Валерыя Валянцінавіча|	Шархун Валерый Валянцінавіч
Шаршуновіча Міхаіла Валер’евіча|	Шаршуновіч Міхаіл Валер’евіч
Шаферава Дзмітрыя Мікалаевіча|	Шафераў Дзмітрый Мікалаевіч
Шведава Генадзія Мікалаевіча|	Шведаў Генадзій Мікалаевіч
Шота Дзмітрыя Часлававіча|	Шот Дзмітрый Часлававіч
Шпілеўскага Уладзіміра Віктаравіча|	Шпілеўскі Уладзімір Віктаравіч
Шубянка Андрэя Мікалаевіча|	Шубянок Андрэй Мікалаевіч
Шулькіна Дзмітрыя Вячаслававіча|	Шулькін Дзмітрый Вячаслававіч
Шумака Валерыя Міхайлавіча|	Шумак Валерый Міхайлавіч
Шушлакова Юрыя Леанідавіча|	Шушлакоў Юрый Леанідавіч
Шчабятка Аляксандра Міхайлавіча|	Шчабятк Аляксандр Міхайлавіч
Шчаглова Андрэя Генадзьевіча|	Шчаглоў Андрэй Генадзьевіч
Шчарбака Яўгенія Міхайлавіча|	Шчарбак Яўгеній Міхайлавіч
Шчарбянка Сяргея Мікалаевіча|	Шчарбянок Сяргей Мікалаевіч
Шчупачонка Валерыя Вітальевіча|	Шчупачонак Валерый Вітальевіч
Шылава Валерыя Георгіевіча|	Шылаў Валерый Георгіевіч
Шыленка Канстанціна Валер’евіча|	Шыленок Канстанцін Валер’евіч
Шыманца Сяргея Мікалаевіча|	Шыманец Сяргей Мікалаевіч
Шышкіна Аляксандра Васільевіча|	Шышкін Аляксандр Васільевіч
Шэлеста Аляксандра Уладзіміравіча|	Шэлест Аляксандр Уладзіміравіч
Шэнца Ігара Віктаравіча|	Шэнец Ігар Віктаравіч
Шэраша Ігара Міхайлавіча|	Шэраш Ігар Міхайлавіч
Шэўчыка Сяргея Вячаслававіча|	Шэўчык Сяргей Вячаслававіч
Юрчанку Мікалая Мікалаевіча|	Юрчанка Мікалай Мікалаевіч
Юхімука Юрыя Міхайлавіча|	Юхімук Юрый Міхайлавіч
Юхімца Барыса Іванавіча|	Юхімц Барыс Іванавіч
Юшкевіча Вячаслава Казіміравіча|	Юшкевіч Вячаслаў Казіміравіч
Юшко Ігара Мікалаевіча|	Юшко Ігар Мікалаевіч
Ягоркіна Алега Іванавіча|	Ягоркін Алег Іванавіч
Якавенку Аляксандра Пятровіча|	Якавенка Аляксандр Пятровіч
Якімовіча Сяргея Уладзіміравіча|	Якімовіч Сяргей Уладзіміравіч
Якусіка Івана Станіслававіча|	Якусік Іван Станіслававіч
Якшука Генадзія Мечаслававіча|	Якшук Генадзій Мечаслававіч
Януця Паўла Валер’евіча|	Януць Павел Валер’евіч
Янушкевіча Валерыя Іванавіча|	Янушкевіч Валерый Іванавіч
Ярашэвіча Валерыя Уладзіміравіча|	Ярашэвіч Валерый Уладзіміравіч
Ярмака Уладзіміра Міхайлавіча|	Ярмак Уладзімір Міхайлавіч
Ярмоленка Таццяну Мікалаеўну|	Ярмоленка Таццяна Мікалаеўна
Ярмольчыка Анатоля Уладзіміравіча|	Ярмольчык Анатоль Уладзіміравіч
Ярцава Аляксандра Мікалаевіча|	Ярцаў Аляксандр Мікалаевіч
Ярчука Ігара Леанідавіча|	Ярчук Ігар Леанідавіч
Яшчанку Сяргея Анатольевіча|	Яшчанка Сяргей Анатольевіч
Казеку Мікалая Іванавіча|	Казека Мікалай Іванавіч
Кушніра Антона Сяргеевіча|	Кушнір Антон Сяргеевіч
Скардзіна Надзею Валер’еўну|	Скардзіна Надзея Валер’еўна
Цупер Алу Пятроўну|	Цупер Ала Пятроўна
Цыбульскага Андрыяна Аляксеевіча|	Цыбульскі Андрыян Аляксеевіч
Булыгіна Сяргея Іванавіча|	Булыгін Сяргей Іванавіч
Далідовіча Сяргея Мікалаевіча|	Далідовіч Сяргей Мікалаевіч
Рыбіну Ірыну Леанідаўну|	Рыбіна Ірына Леанідаўна
Співакова Уладзіміра Тэадоравіча|	Співакоў Уладзімір Тэадоравіч
Васілеўскага Яўгена Васільевіча|	Васілеўскі Яўген Васільевіч
Пугачова Васіля Паўлавіча|	Пугачоў Васіль Паўлавіч
Шухно Сяргея Сцяпанавіча|	Шухно Сяргей Сцяпанавіч
Барысевіча Мікалая Мікалаевіча|	Барысевіч Мікалай Мікалаевіч
Шыха Віктара Адамавіча|	Шых Віктар Адамавіч
Шунько Івана Сцяпанавіча|	Шунько Іван Сцяпанавіч
Буфала Сяргея Аляксандравіча|	Буфал Сяргей Аляксандравіч
Васілеўскага Валерыя Васільевіча|	Васілеўскі Валерый Васільевіч
Жога Алу Іванаўну|	Жога Ала Іванаўна
Сямёнаву Наталлю Пятроўну|	Сямёнава Наталля Пятроўна
Шамчака Уладзіміра Мікалаевіча|	Шамчак Уладзімір Мікалаевіч
Глушакова Цімафея Іванавіча|	Глушакоў Цімафей Іванавіч
Мядзведзеву Вольгу Аляксандраўну|	Мядзведзева Вольга Аляксандраўна
Мятлікава Міхаіла Міхайлавіча|	Мятлікаў Міхаіл Міхайлавіч
Сасноўскага Аляксандра Аляксандравіча|	Сасноўскі Аляксандр Аляксандравіч
Альберса Юрыя Юр’евіча|	Альберс Юрый Юр’евіч
Бірскага Ігара Браніслававіча|	Бірскі Ігар Браніслававіч
Кручка Кірыла Генадзьевіча|	Кручк Кірыл Генадзьевіч
Пастухова Анатолія Сямёнавіча|	Пастухоў Анатолій Сямёнавіч
Семенякова Андрэя Васільевіча|	Семенякоў Андрэй Васільевіч
Філімонава Андрэя Юр’евіча|	Філімонаў Андрэй Юр’евіч
Пісараву Надзею Міхайлаўну|	Пісарава Надзея Міхайлаўна
Чыгрынава Сяргея Пятровіча|	Чыгрынаў Сяргей Пятровіч
Ерамееву Ірыну Валер’еўну|	Ерамеева Ірына Валер’еўна
Жыбурт Святлану Васільеўну|	Жыбурт Святлана Васільеўна
Захаранка Алену Пятроўну|	Захаранка Алена Пятроўна
Мацакаву Таццяну Віктараўну|	Мацакава Таццяна Віктараўна
Тарасавец Святлану Адамаўну|	Тарасавец Святлана Адамаўна
Сасноўскую Аксану Яўгеньеўну|	Сасноўская Аксана Яўгеньеўна
Бядуліну Ірыну Міхайлаўну|	Бядуліна Ірына Міхайлаўна
Вайценкову Даурыю Анфісаўну|	Вайценкова Даурыя Анфісаўна
Галабурда Лілію Станіславаўну|	Галабурда Лілія Станіславаўна
Навічонак Галіну Уладзіміраўну|	Навічонак Галіна Уладзіміраўна
Пускову Вольгу Вячаславаўну|	Пускова Вольга Вячаславаўна
Рубінава Анатолія Мікалаевіча|	Рубінаў Анатолій Мікалаевіч
Тозіка Анатолія Афанасьевіча|	Тозік Анатолій Афанасьевіч
Альшванга Барыса Рудольфавіча|	Альшванг Барыс Рудольфавіч
Мазынскую Ларысу Мікалаеўну|	Мазынская Ларыса Мікалаеўна
Мацюха Mіxaіла Рыгоравіча|	Мацюх Mіxaіл Рыгоравіч
Стасюка Анатолія Мікалаевіча|	Стасюк Анатолій Мікалаевіч
Чарадніка Георгія Барысавіча|	Чараднік Георгій Барысавіч
Жукоўскую Алу Анатольеўну|	Жукоўская Ала Анатольеўна
Коршун Надзею Іванаўну|	Коршун Надзея Іванаўна
Анішчыка Мікалая Мікалаевіча|	Анішчык Мікалай Мікалаевіч
Дубіка Івана Іванавіча|	Дубік Іван Іванавіч
Жэлябоўскага Андрэя Юр’евіча|	Жэлябоўскі Андрэй Юр’евіч
Землякова Ігара Анатольевіча|	Землякоў Ігар Анатольевіч
Казлоўскую Надзею Валер’еўну|	Казлоўская Надзея Валер’еўна
Латушкіна Сяргея Пятровіча|	Латушкін Сяргей Пятровіч
Лаўрэнцьева Вячаслава Васільевіча|	Лаўрэнцьеў Вячаслаў Васільевіч
Мазалевіча Юрыя Уладзіміравіча|	Мазалевіч Юрый Уладзіміравіч
Мечнік Любоў Андрэеўну|	Мечнік Любоў Андрэеўна
Пучкова Генадзія Міхайлавіча|	Пучкоў Генадзій Міхайлавіч
Сасноўскую Таццяну Валер’еўну|	Сасноўская Таццяна Валер’еўна
Барбоцьку Цімафея Валянцінавіча|	Барбоцька Цімафей Валянцінавіч
Прыткова Валерыя Аляксандравіча|	Прыткоў Валерый Аляксандравіч
Чупіка Мікалая Канстанцінавіча|	Чупік Мікалай Канстанцінавіч
Белацаркоўскаму Рыгору Якаўлевічу|	Белацаркоўскі Рыгор Якаўлевіч
Осіпавай Ніне Віктараўне|	Осіпава Ніна Віктараўна
Нягрэю Віктару Якаўлевічу|	Нягрэй Віктар Якаўлевіч
Гурэвічу Аляксандру Рафаілавічу|	Гурэвіч Аляксандр Рафаілавіч
Уссу Анатолію Леанідавічу|	Усс Анатолій Леанідавіч
Грышуку Анатолію Георгіевічу|	Грышук Анатолій Георгіевіч
Міхалевічу Аляксандру Аляксандравічу|	Міхалевіч Аляксандр Аляксандравіч
Баравому Мікалаю Іванавічу|	Баравом Мікалай Іванавіч
Лозікавай Таццяне Міхаілаўне|	Лозікава Таццяна Міхаілаўна
Кузняцову Канстанціну Анатольевічу|	Кузняцоў Канстанцін Анатольевіч
Гальцу Васілю Мікалаевічу|	Гальц Васіль Мікалаевіч
Ксёнцу Уладзіміру Мікалаевічу|	Ксёнц Уладзімір Мікалаевіч
Дзялендзіку Анатолію Андрэевічу|	Дзялендзік Анатолій Андрэевіч
Паніну Вячаславу Мікалаевічу|	Панін Вячаслаў Мікалаевіч
Сакаловай Алене Канстанцінаўне|	Сакалова Алена Канстанцінаўна
Кавалені Аляксандру Аляксандравічу|	Каваленя Аляксандр Аляксандравіч
Маразевічу Анатолю Мікалаевічу|	Маразевіч Анатоль Мікалаевіч
Вільчуку Канстанціну Усцінавічу|	Вільчук Канстанцін Усцінавіч
Дубу Ігару Дзмітрыевічу|	Дуб Ігар Дзмітрыевіч
Радцэвіч Вользе Рыгораўне|	Радцэвіч Вольга Рыгораўна
Каралю Аляксандру Іванавічу|	Караль Аляксандр Іванавіч
Самасюку Уладзіміру Георгіевічу|	Самасюк Уладзімір Георгіевіч
Паўлоўскаму Тадэвушу Енрыкавічу|	Паўлоўскі Тадэвуш Енрыкавіч
Горбелю Мікалаю Васільевічу|	Горбель Мікалай Васільевіч
Барадзіной Людміле Афанасьеўне|	Барадзіна Людміла Афанасьеўна
Гусаву Андрэю Леанідавічу|	Гусаў Андрэй Леанідавіч
Асташэвічу Андрэю Уладзіміравічу|	Асташэвіч Андрэй Уладзіміравіч
Беламу Паўлу Аляксандравічу|	Белы Павел Аляксандравіч
Задзелёнаву Сяргею Аляксандравічу|	Задзелёнаў Сяргей Аляксандравіч
Міхалёву Андрэю Аляксандравічу|	Міхалёў Андрэй Аляксандравіч
Савілаву Генадзію Генадзьевічу|	Савілаў Генадзій Генадзьевіч
Аляксееву Аляксандру Юр’евічу|	Аляксееў Аляксандр Юр’евіч
Летаву Яўгенію Уладзіміравічу|	Летаў Яўгеній Уладзіміравіч
Свіце Уладзіміру Фердзінантавічу|	Світа Уладзімір Фердзінантавіч
Слышу Максіму Юр’евічу|	Слыш Максім Юр’евіч
Аўрукевічу Аляксандру Міхайлавічу|	Аўрукевіч Аляксандр Міхайлавіч
Герасевічу Івану Пракопавічу|	Герасевіч Іван Пракопавіч
Кашпераву Аляксандру Барысавічу|	Кашпераў Аляксандр Барысавіч
Шкарубу Валерыю Федаравічу|	Шкаруб Валерый Федаравіч
Семчанка Таццяне Паўлаўне|	Семчанка Таццяна Паўлаўна
Адашкевіч Ларысе Аляксандраўне|	Адашкевіч Ларыса Аляксандраўна
Папкоўскай Пелагеі Якаўлеўне|	Папкоўская Пелагея Якаўлеўна
Рагаўцову Васілю Іванавічу|	Рагаўцоў Васіль Іванавіч
Супруну Міхаілу Пятровічу|	Супрун Міхаіл Пятровіч
Папкову Сяргею Пятровічу|	Папкоў Сяргей Пятровіч
Пенігіну Аляксандру Сяргеевічу|	Пенігін Аляксандр Сяргеевіч
Свобадзе Фёдару Анатольевічу|	Свобада Фёдар Анатольевіч
Варановічу Тадэушу Валянцінавічу|	Варановіч Тадэуш Валянцінавіч
Домрачэвай Дар’і Уладзіміраўне|	Домрачэва Дар’я Уладзіміраўна
Балановіча Анатолія Раманавіча|	Балановіч Анатолій Раманавіч
Герасімчыка Аляксандра Пятровіча|	Герасімчык Аляксандр Пятровіч
Смірнова Алега Феліксавіча|	Смірноў Алег Феліксавіч
Стрыгалева Алега Іванавіча|	Стрыгалеў Алег Іванавіч
Шутава Сяргея Васільевіча|	Шутаў Сяргей Васільевіч
Батыя Мікалая Леанідавіча|	Батый Мікалай Леанідавіч
Богданава Уладзіміра Барысавіча|	Богданаў Уладзімір Барысавіч
Бурдыку Аляксандра Пятровіча|	Бурдыка Аляксандр Пятровіч
Буякевіча Аляксандра Леанідавіча|	Буякевіч Аляксандр Леанідавіч
Васількова Віктара Васільевіча|	Васількоў Віктар Васільевіч
Гоціну Лідзію Мяфодзьеўну|	Гоціна Лідзія Мяфодзьеўна
Грыгарэнку Дзмітрыя Мікалаевіча|	Грыгарэнка Дзмітрый Мікалаевіч
Жоўну Андрэя Васілевіча|	Жоўна Андрэй Васілевіч
Ілюшына Валерыя Валянцінавіча|	Ілюшын Валерый Валянцінавіч
Камара Алега Уладзіміравіча|	Камар Алег Уладзіміравіч
Касаева Сяргея Анатольевіча|	Касаеў Сяргей Анатольевіч
Качалоўскую Святлану Валер’еўну|	Качалоўская Святлана Валер’еўна
Мяцельскага Андрэя Іванавіча|	Мяцельскі Андрэй Іванавіч
Новікава Сяргея Мікалаевіча|	Новікаў Сяргей Мікалаевіч
Палтараку Вячаслава Васільевіча|	Палтарака Вячаслаў Васільевіч
Прароўскага Вячаслава Міхайлавіча|	Прароўскі Вячаслаў Міхайлавіч
Рахубава Анатолія Еўдакімавіча|	Рахубаў Анатолій Еўдакімавіч
Сілкова Юрыя Міхайлавіча|	Сілкоў Юрый Міхайлавіч
Слабадняка Сяргея Уладзіміравіча|	Слабадняк Сяргей Уладзіміравіч
Царука Віктара Іванавіча|	Царук Віктар Іванавіч
Целяшынскага Івана Рышардавіча|	Целяшынскі Іван Рышардавіч
Шарэйку Аляксандра Анатольевіча|	Шарэйка Аляксандр Анатольевіч
Шумая Сяргея Міхайлавіча|	Шумай Сяргей Міхайлавіч
Александровіча Сяргея Станіслававіча|	Александровіч Сяргей Станіслававіч
Ананьеву Валянціну Мікалаеўну|	Ананьева Валянціна Мікалаеўна
Аніська Святлану Уладзіміраўну|	Аніська Святлана Уладзіміраўна
Анціпава Алега Міхайлавіча|	Анціпаў Алег Міхайлавіч
Асоку Вячаслава Аляксандравіча |	Асока Вячаслаў Аляксандравіч
Аушава Ігара Юр’евіча|	Аушаў Ігар Юр’евіч
Балакірава Уладзіміра Ільіча|	Балакіраў Уладзімір Ільіч
Бараноўскага Анатолія Васільевіча|	Бараноўскі Анатолій Васільевіч
Барысенку Руслана Уладзіміравіча|	Барысенка Руслан Уладзіміравіч
Барычэўскага Рамана Вітальевіча|	Барычэўскі Раман Вітальевіч
Басько Сяргея Анатольевіча|	Басько Сяргей Анатольевіч
Белаблоцкага Юрыя Міхайлавіча|	Белаблоцкі Юрый Міхайлавіч
Берсунукаева Вадзіма Вахідавіча|	Берсунукаеў Вадзім Вахідавіч
Буткевіча Дзмітрыя Сцяпанавіча|	Буткевіч Дзмітрый Сцяпанавіч
Быкава Андрэя Уладзіміравіча|	Быкаў Андрэй Уладзіміравіч
Бяршова Віталія Анатольевіча|	Бяршоў Віталій Анатольевіч
Вазняка Вадзіма Валер’евіча|	Вазняк Вадзім Валер’евіч
Варанько Іну Сямёнаўну|	Варанько Іна Сямёнаўна
Варэніка Уладзіміра Іванавіча|	Варэнік Уладзімір Іванавіч
Васілеўскага Васілія Філіпавіча|	Васілеўскі Васілій Філіпавіч
Васільева Сяргея Аляксандравіча|	Васільеў Сяргей Аляксандравіч
Васюка Сяргея Часлававіча|	Васюк Сяргей Часлававіч
Вашкевіча Юрыя Лявонавіча|	Вашкевіч Юрый Лявонавіч
Ваяводзенку Сяргея Адамавіча|	Ваяводзенка Сяргей Адамавіч
Верамея Паўла Пятровіча|	Верамей Павел Пятровіч
Верхаўцова Пятра Пятровіча|	Верхаўцоў Пётр Пятровіч
Вішкоўскага Аляксандра Віктаравіча|	Вішкоўскі Аляксандр Віктаравіч
Вішнеўскага Уладзіміра Фёдаравіча|	Вішнеўскі Уладзімір Фёдаравіч
Галіцкага Віктара Уладзіміравіча|	Галіцкі Віктар Уладзіміравіч
Галякову Ірыну Віктараўну|	Галякова Ірына Віктараўна
Гейдана Дзмітрыя Уладзіміравіча|	Гейдан Дзмітрый Уладзіміравіч
Гняцько Віктара Іванавіча|	Гняцько Віктар Іванавіч
Горнага Уладзіміра Паўлавіча|	Горны Уладзімір Паўлавіч
Грыцкевіча Аляксандра Мікалаевіча|	Грыцкевіч Аляксандр Мікалаевіч
Давідовіча Вячаслава Уладзіміравіча|	Давідовіч Вячаслаў Уладзіміравіч
Давыдоўскага Дзяніса Мікалаевіча|	Давыдоўскі Дзяніс Мікалаевіч
Дзёшына Дзяніса Міхайлавіча|	Дзёшын Дзяніс Міхайлавіч
Дзмітрук Алену Георгіеўну|	Дзмітрук Алена Георгіеўна
Дзмітрука Сцяпана Сцяпанавіча|	Дзмітрук Сцяпан Сцяпанавіч
Доўнара Аляксандра Антонавіча|	Доўнар Аляксандр Антонавіч
Дубіну Сяргея Уладзіміравіча|	Дубіна Сяргей Уладзіміравіч
Дубіцкага Віталія Уладзіміравіча|	Дубіцкі Віталій Уладзіміравіч
Дудука Сяргея Даніілавіча|	Дудук Сяргей Даніілавіч
Жуковіча Сяргея Рыгоравіча|	Жуковіч Сяргей Рыгоравіч
Жытнікава Віталія Аляксеевіча|	Жытнікаў Віталій Аляксеевіч
Зайко Дзмітрыя Яўгеньевіча|	Зайко Дзмітрый Яўгеньевіч
Зайцава Вадзіма Барысавіча|	Зайцаў Вадзім Барысавіч
Змітровіч Ірыну Эдвардаўну|	Змітровіч Ірына Эдвардаўна
Зубача Яраслава Уладзіміравіча|	Зубач Яраслаў Уладзіміравіч
Іванова Аляксея Арсеньявіча|	Іваноў Аляксей Арсеньявіч
Казуціна Яўгенія Генадзьевіча|	Казуцін Яўгеній Генадзьевіч
Каліноўскага Васіля Васільевіча|	Каліноўскі Васіль Васільевіч
Капуцкую Вольгу Георгіеўну|	Капуцкая Вольга Георгіеўна
Карпеку Уладзіміра Міхайлавіча|	Карпека Уладзімір Міхайлавіч
Каташэнку Аляксея Іванавіча|	Каташэнка Аляксей Іванавіч
Качулу Аляксандра Мікалаевіча|	Качула Аляксандр Мікалаевіч
Клешчанку Вадзіма Міхайлавіча|	Клешчанка Вадзім Міхайлавіч
Кнігу Уладзіміра Валянцінавіча|	Кніга Уладзімір Валянцінавіч
Коваля Аляксандра Уладзіміравіча |	Коваль Аляксандр Уладзіміравіч
Козела Мечыслава Леанардавіча|	Козел Мечыслаў Леанардавіч
Козела Міхаіла Іванавіча|	Козел Міхаіл Іванавіч
Коржыка Івана Мікалаевіча|	Коржык Іван Мікалаевіч
Котава Аляксандра Уладзіміравіча |	Котаў Аляксандр Уладзіміравіч
Крэўчыка Аляксандра Мечэслававіча |	Крэўчык Аляксандр Мечэслававіч
Кузняцова Дзмітрыя Сяргеевіча|	Кузняцоў Дзмітрый Сяргеевіч
Кузьмянкова Юрыя Алегавіча|	Кузьмянкоў Юрый Алегавіч
Кульбіцкага Аляксея Уладзіміравіча|	Кульбіцкі Аляксей Уладзіміравіч
Куратнікава Андрэя Алегавіча|	Куратнікаў Андрэй Алегавіч
Ладзяту Уладзіміра Георгіевіча|	Ладзята Уладзімір Георгіевіч
Лашчука Сяргея Фёдаравіча|	Лашчук Сяргей Фёдаравіч
Лейку Аляксандра Канстанцінавіча |	Лейка Аляксандр Канстанцінавіч
Леўковіча Сяргея Андрэевіча|	Леўковіч Сяргей Андрэевіч
Ліпскага Уладзіміра Уладзіміравіча |	Ліпскі Уладзімір Уладзіміравіч
Ліхадзіеўскага Дзмітрыя Леанідавіча|	Ліхадзіеўскі Дзмітрый Леанідавіч
Лобана Андрэя Анатольевіча|	Лобан Андрэй Анатольевіч
Лысуху Аляксандра Юр’евіча|	Лысуха Аляксандр Юр’евіч
Любінскага Дзмітрыя Васільевіча|	Любінскі Дзмітрый Васільевіч
Ляпешку Дзмітрыя Алегавіча|	Ляпешка Дзмітрый Алегавіч
Лясовіча Сяргея Генадзьевіча|	Лясовіч Сяргей Генадзьевіч
Мазаля Дзмітрыя Генадзьевіча|	Мазаль Дзмітрый Генадзьевіч
Максіменку Сяргея Мікалаевіча|	Максіменка Сяргей Мікалаевіч
Малафееўскага Леаніда Альбертавіча|	Малафееўскі Леанід Альбертавіч
Малышчыка Андрэя Анатольевіча|	Малышчык Андрэй Анатольевіч
Мальца Валерыя Яўгеньевіча|	Мальц Валерый Яўгеньевіч
Мамацюка Аляксандра Сяргеевіча|	Мамацюк Аляксандр Сяргеевіч
Марозаву Святлану Аляксандраўну|	Марозава Святлана Аляксандраўна
Маскаленку Ігара Пятровіча|	Маскаленка Ігар Пятровіч
Маслёнчанку Анатолія Васільевіча|	Маслёнчанка Анатолій Васільевіч
Мельячэнку Пятра Пятровіча|	Мельячэнка Пётр Пятровіч
Місюкевіч Людмілу Станіславаўну|	Місюкевіч Людміла Станіславаўна
Міхалюка Сяргея Аляксеевіча|	Міхалюк Сяргей Аляксеевіч
Мяцеліцу Аляксея Вячаслававіча|	Мяцеліца Аляксей Вячаслававіч
Навасельцава Вячаслава Аляксандравіча |	Навасельцаў Вячаслаў Аляксандравіч
Нацэўскага Аляксандра Георгіевіча|	Нацэўскі Аляксандр Георгіевіч
Невяроўскага Алега Станіслававіча|	Невяроўскі Алег Станіслававіч
Несцяронка Івана Мікалаевіча|	Несцяронак Іван Мікалаевіч
Падаляку Уладзіміра Віктаравіча|	Падаляка Уладзімір Віктаравіч
Падгорскага Аляксандра Віктаравіча|	Падгорскі Аляксандр Віктаравіч
Пажывілку Руслана Аляксеевіча|	Пажывілка Руслан Аляксеевіч
Пазднякову Ірыну Міхайлаўну|	Пазднякова Ірына Міхайлаўна
Палазка Сяргея Мікалаевіча|	Палазк Сяргей Мікалаевіч
Папыліна Уладзіміра Мікалаевіча|	Папылін Уладзімір Мікалаевіч
Парфёнава Юрыя Уладзіміравіча|	Парфёнаў Юрый Уладзіміравіч
Патапенку Сяргея Васільевіча|	Патапенка Сяргей Васільевіч
Паўлюкевіча Мікалая Антонавіча|	Паўлюкевіч Мікалай Антонавіч
Пахомава Юрыя Аляксандравіча|	Пахомаў Юрый Аляксандравіч
Пецюка Сяргея Барысавіча|	Пецюк Сяргей Барысавіч
Півавара Генадзія Міхайлавіча|	Півавар Генадзій Міхайлавіч
Пілецкага Івана Міфодзьевіча|	Пілецкі Іван Міфодзьевіч
Пілюшына Сяргея Пятровіча|	Пілюшын Сяргей Пятровіч
Плытніка Міхаіла Міхайлавіча|	Плытнік Міхаіл Міхайлавіч
Протаса Андрэя Міхайлавіча|	Протас Андрэй Міхайлавіч
Прышчэпава Аляксандра Уладзіміравіча |	Прышчэпаў Аляксандр Уладзіміравіч
Пушкарова Андрэя Міхайлавіча|	Пушкароў Андрэй Міхайлавіч
Пятрэнка Вераніку Уладзіміраўну|	Пятрэнка Вераніка Уладзіміраўна
Пячынскага Валер’яна Канстанцінавіча|	Пячынскі Валяр’ян Канстанцінавіч
Ракоўскага Міхаіла Міхайлавіча|	Ракоўскі Міхаіл Міхайлавіч
Родзіну Галіну Пятроўну|	Родзіна Галіна Пятроўна
Рыліка Андрэя Уладзіміравіча|	Рылік Андрэй Уладзіміравіч
Садоўскага Яўгенія Аляксеевіча|	Садоўскі Яўгеній Аляксеевіч
Сапоненку Сяргея Васільевіча|	Сапоненка Сяргей Васільевіч
Свірко Аляксандра Анатольевіча|	Свірко Аляксандр Анатольевіч
Седога Сяргея Міхайлавіча|	Седог Сяргей Міхайлавіч
Сімінскага Дзмітрыя Леанідавіча|	Сімінскі Дзмітрый Леанідавіч
Сінігаева Аляксандра Цярэнцьевіча|	Сінігаеў Аляксандр Цярэнцьевіч
Скапца Дзмітрыя Мікалаевіча|	Скапц Дзмітрый Мікалаевіч
Слабко Сяргея Георгіевіча|	Слабко Сяргей Георгіевіч
Сокалава Віталія Віктаравіча|	Сокалаў Віталій Віктаравіч
Станько Андрэя Іванавіча|	Станько Андрэй Іванавіч
Сулімава Ігара Віктаравіча|	Сулімаў Ігар Віктаравіч
Сцяпанава Андрэя Аляксеявіча|	Сцяпанаў Андрэй Аляксеявіч
Токарава Аляксандра Іванавіча|	Токараў Аляксандр Іванавіч
Трафімчука Анатолія Георгіевіча|	Трафімчук Анатолій Георгіевіч
Трухана Дзмітрыя Аляксандравіча|	Трухан Дзмітрый Аляксандравіч
Усанава Сяргея Іванавіча|	Усанаў Сяргей Іванавіч
Ускова Міхаіла Віктаравіча|	Ускоў Міхаіл Віктаравіч
Федаровіча Івана Янавіча|	Федаровіч Іван Янавіч
Харольскага Дзмітрыя Барысавіча|	Харольскі Дзмітрый Барысавіч
Хаўпуна Ігара Міхайлавіча|	Хаўпун Ігар Міхайлавіч
Хацяновіча Ігара Міхайлавіча|	Хацяновіч Ігар Міхайлавіч
Ціханенку Дзмітрыя Барысавіча|	Ціханенка Дзмітрый Барысавіч
Ціхенку Ігара Анатольевіча|	Ціхенка Ігар Анатольевіч
Цярноўцава Сяргея Уладзіміравіча|	Цярноўцаў Сяргей Уладзіміравіч
Цяртычнага Канстанціна Валер’евіча|	Цяртычны Канстанцін Валер’евіч
Чарнова Уладзіміра Валерыевіча|	Чарноў Уладзімір Валерыевіч
Чарнякевіча Івана Іванавіча|	Чарнякевіч Іван Іванавіч
Чыркову Святлану Аляксандраўну|	Чыркова Святлана Аляксандраўна
Шапялевіча Віктара Мікалаевіча|	Шапялевіч Віктар Мікалаевіч
Шашкова Аляксандра Міхайлавіча|	Шашкоў Аляксандр Міхайлавіч
Шпакевіча Івана Рыгоравіча|	Шпакевіч Іван Рыгоравіч
Шульгу Ягора Мікалаевіча|	Шульга Ягор Мікалаевіч
Шуранкова Валерыя Уладзіміравіча|	Шуранкоў Валерый Уладзіміравіч
Шчаўроўскага Андрэя Алегавіча|	Шчаўроўскі Андрэй Алегавіч
Шэнаева Андрэя Вітальевіча|	Шэнаеў Андрэй Вітальевіч
Юхновіча Ігара Пятровіча|	Юхновіч Ігар Пятровіч
2512
Mіxaіл   1
Алег     66
Альберт  3
Альгірдас 1
Аляксандр 283
Аляксей  53
Анатолій 44
Анатоль  9
Андрыс   1
Андрыус  1
Андрыян  1
Андрэй   148
Анжэй    2
Антон    6
Аркадзій 2
Арнольд  1
Артур    1
Арцем    1
Барыс    6
Вадзім   29
Валерый  70
Валянцін 6
Валяр’ян 1
Васілій  29
Васіль   13
Віктар   65
Віталій  65
Віталь   7
Вячаслаў 35
Генадзій 24
Генадзь  5
Генрык   1
Георгій  1
Герман   1
Грыгорый 2
Данііл   1
Даніл    1
Даніла   1
Джафер   1
Дзмітрый 122
Дзяніс   18
Іван     37
Ігар     104
Ілья     4
Іосіф    4
Казімір  1
Канстанцін 17
Кірыл    6
Леанід   18
Леў      1
Максім   19
Мечыслаў 1
Мікалай  76
Міхаіл   60
Павел    38
Пётр     20
Раман    6
Расціслаў 1
Роберт   1
Руслан   14
Рыгор    7
Святаслаў 1
Спартак  1
Станіслаў 11
Сцяпан   5
Сямён    2
Сяргей   242
Тадэвуш  2
Тадэуш   1
Тарас    1
Уктам    1
Уладзімір 125
Уладзіслаў 6
Фёдар    4
Цімафей  4
Цімур    1
Часлаў   1
Эдуард   12
Юрый     80
Ягор     2
Яраслаў  1
Яўген    5
Яўгеній  27
Яфім     1
Іна      6
Інеса    2
Ірына    35
Аксана   8
Ала      8
Алена    40
Алеся    3
Аляксандра 1
Анастасся 1
Анастасія 1
Антаніна 3
Аэліта   1
Валянціна 18
Вера     1
Вераніка 3
Вольга   27
Вікторыя 4
Віялета  1
Галіна   14
Ганна    10
Данута   1
Дар’я    1
Даурыя   1
Жана     2
Жанна    2
Зоя      3
Зінаіда  2
Карына   1
Кацярына 1
Ларыса   9
Любоў    3
Людміла  21
Лідзія   4
Ліля     1
Лілія    2
Ліяна    1
Маргарыта 2
Марына   6
Марыя    4
Надзежда 1
Надзея   12
Настасся 1
Наталля  36
Наталія  3
Нона     1
Ніна     3
Пелагея  1
Раіса    3
Святлана 29
Софія    1
Тамара   7
Таццяна  42
Таіса    1
Таісія   1
Тэрэса   1
Юлія     4
Яніна    1
